修宪	whpt
上颔	hgwy
上颚	hgkk
舍宾	wfpr
花仙	awwm
恶男	gole
冀中	uxkh
房企	ynwh
醉驾	sgek
脚骨	efme
房市	ynym
恐高	awyk
别哭	kekk
免灾	qkpo
腿骨	evme
茸毛	abtf
加加	ekek
创效	wbyw
掐住	rqwy
铝壳	qkfp
刷浴	nmiw
力挺	enrt
卡丁	hgsg
扑翼	rhnl
猪脑	qtey
卤子	hlbb
北村	uxsf
手链	rtql
双基	ccad
掐痕	rquv
南漂	fmis
右掌	dkip
除奸	bwvf
男款	leff
蕲竹	auth
无匹	fqaq
蕲艾	auar
右胸	dkeq
右脸	dkew
蕲蛇	aujp
陶笛	bqtm
的姐	rqve
省局	itnn
阳面	bjdm
蕲龟	auqj
除魔	bwos
音爆	ujoj
暖脚	jeef
曲笛	matm
基价	adww
梆子	sdbb
香樟	tjsu
堰塞	fapa
标王	sfgg
林西	sssg
梦溪	ssie
梆笛	sdtm
槐南	srfm
困鸟	lsqy
窨井	pwfj
夺宝	dfpg
奇思	dsln
大桶	ddsc
妙想	vish
西陵	sgbf
大爱	ddep
证函	ygbi
议和	yytk
大瓶	ddua
大袋	ddwa
止吐	hhkf
竹笛	thtm
宰客	pupt
孤枕	brsp
起搏	fhrg
正西	ghsg
鸡柳	cqsq
浙南	irfm
走穴	fhpw
正高	ghyk
紫竹	hxth
浅棕	ifsp
龙卵	dxqy
流注	iyiy
鼠族	enyt
湘妃	isvn
练摊	xarc
绝景	xqjy
上册	hgmm
较浅	lyif
九型	vtga
红缨	xaxm
中序	khoc
职代	bkwa
红药	xaax
为憾	ytnd
逐波	geih
溶脂	ipex
东环	aigd
酒圣	iscf
弱水	xuii
专网	fnmr
余弦	wgxy
会标	wfsf
