妙想天开	vsgg
破破烂烂	ddoo
灵魂出窍	vfbp
善者不来	ufdg
五言绝句	gyxq
小鸭五笔	ilgt
回天无力	lgfe
弦外之意	xqpu
浪蝶狂蜂	ijqj
恩威并施	lduy
叽叽歪歪	kkdd
疏财仗义	nmwy
反唇相稽	rdst
合久必分	wqnw
号啕大哭	kkdk
方便之门	ywpu
铭记在心	qydn
促膝而谈	wedy
阳盛阴衰	bdby
引以为憾	xnyn
