帮顶	dtsd
五角场	ggqe
股沟	ewiq
交稿	ywty
建国大业	vglg
网镖	mrqs
李冰冰	sbui
保命	wkwg
平道	guut
中裤	khpu
令狐	wyqt
平邑	gukc
临街	jttf
金塔	qqfa
众泰	wwdw
志新	fnus
黄金岛	amqq
老肥	ftec
达飞	dpnu
忍术	vysy
广达	oydp
重头	tgud
联盛	budn
酒桌	ishj
脚弓	efxn
彩玉	esgy
乳膏	ebyk
一辈	gghd
耍耍	dmdm
临西	jtsg
恒基	ngad
烟圈	ollu
腐女	owvv
很烂	tvou
烟花易冷	olaw
使我	wgtr
道袍	utpu
醉拳	sgud
五级	ggxb
万达	gqdp
食人魔	wyww
耐脏	dmeo
银月城	qvee
建设路	vgyw
胀气	etrn
三道	dgut
逛逛	qtqt
联社	bupy
五羊	ggug
速运	gkfc
联票	busf
另谋高就	keya
张靓颖	xtge
二胎	fgec
灞桥	ifst
炫彩	oyes
金寨	qqpa
仙石	wmdg
开药	gaax
索菲亚	fpah
古天乐	dggd
潜行	iftg
彩盒	eswg
电脑桌	jney
四点半	lhhk
佰易	wdjq
怨念	qbwy
保外	wkqh
东软	ailq
张翰	xtfj
干锅	fgqk
二舅	fgel
女中豪杰	vvkh
德清	tfig
成绩表	dnxg
酒水	isii
胶条	eyts
悬停	egwy
串货	kkwx
滨崎步	ipmd
中路	khkh
恒安	ngpv
脚掌	efip
里布	jfdm
范冰冰	aiui
翼虎	nlha
澳网	itmr
东邦	aidt
选错	tfqa
陈道明	baut
平阴	gube
广铁	oyqr
悲催	hdwm
交联	ywbu
肥牛	ectg
同道中人	mgut
丙酸	gmsg
还魂	dhfc
金帝	qqyu
胶棒	eysd
佳林	wfss
胡歌	desk
恩威	lddg
群里	vtjf
防火门	byoo
金平	qqgu
翘课	atyj
肥猫	ecqt
东里	aijf
两部	gmuk
例文	wgyy
美错	ugqa
腕带	epgk
途锐	wgqu
聚类	bcod
丰达	dhdp
肉盾	mwrf
中通	khce
三鑫	dgqq
候命	whwg
恶女	govv
康辉	ovig
介素	wjgx
狗尾巴草	qtnt
信宜	wype
五菱	ggaf
欧巴桑	arcn
康达	ovdp
胸模	eqsa
何洁	wsif
老街	fttf
有妇之夫	devv
中都	khft
老衲	ftpu
金恩	qqld
丰都	dhft
坏分子	fdwv
快歌	nnsk
思政	lngh
临邑	jtkc
乐购	tnmq
代签	watw
一震	ggfd
配点	sghk
七雄	agdc
惠东	gjai
煤业	oaog
三防	dgby
二虎	fgha
信息网	wyth
配电柜	sgjn
仁者	wfft
供方	wayy
火炬手	oooa
人脉	wwey
自个	thwh
思明	lnje
腿子	evbb
手机费	rtsw
弓虽	xnkj
脚架	efek
开裂	gagq
广顺	oykd
荆棘谷	aggm
胸毛	eqtf
龟兔赛跑	qjqk
底阀	oquw
心照	nyjv
五虎	ggha
隔山打牛	bgmm
保康	wkov
道道	utut
热工	rvaa
自作	thwt
酷派	sgir
他给	wbxw
优盘	wdte
重拳	tgud
自便	thwg
胖熊	euce
书费	nnxj
想个	shwh
东阳	aibj
乐透	tntb
何炅	wsjo
照做	jvwd
下颔	ghwy
设计费	ywyf
重出江湖	tgbm
聚能	bcce
集体照	wyws
那行	ngtg
中钢	khqm
中铁	khqr
以纯	nyxg
安全锁	pvwg
脑残	eygq
轩辕剑	lflf
代缴	waxr
大太阳	dddy
两集	gmwy
众神	wwpy
保户	wkyn
倩女	wgvv
醋溜	sgiq
熊仔	cewb
西三环	sgdg
酱爆	uqoj
弄走	gafh
情圣	ngcf
灰熊	doce
肩章	ynuj
于谦	gfyu
火牛	ootg
两餐	gmhq
灯牌	osth
灯片	osth
发货单	ntwx
城关镇	fdud
里格	jfst
胆码	ejdc
恒昌	ngjj
舅公	elwc
避邪	nkah
熔体	opws
丰顺	dhkd
人模狗样	wwsa
信息表	wyth
酷狗	sgqt
热控	rvrp
倒带	wggk
灰狼	doqt
幼龙	xedx
以史为鉴	nykr
开远	gafq
人行	wwtg
中饭	khqn
建邺	vgog
邦购	dtmq
考试院	ftyg
三鹿	dgon
轻舞飞扬	lcrl
红颜知己	xaut
身轻如燕	tmlc
做回	wdlk
亚贸	goqy
住着	wyug
个高	whyk
快递费	nnux
魂牵梦绕	fcdp
手机链	rtsw
思源	lnid
乐陵	tnbf
仆街	whtf
张超	xtfh
快男	nnle
酸甜	sgtd
道题	utjg
船业	teog
于连	gflp
低碳	wqdm
肥罗	eclq
速龙	gkdx
舍友	wfdc
怒焰	vcoq
灵界	volw
九阳	vtbj
九阴	vtbe
怀玉	ndgy
九院	vtbp
东鹏	aiee
舌吻	tdkq
偿命	wiwg
遭难	gmcw
配管	sgtp
凄凄惨惨	ugug
量比	jgxx
里水	jfii
傻里傻气	wtjf
邦迪	dtmp
肚腩	efef
十字绣	fgpb
臣妾	ahuv
刘胜义	yjet
井道	fjut
老油条	ftim
规格书	fwst
洗发水	itnt
金汇	qqia
金水	qqii
张辽	xtbp
储值	wywf
肥肥	ecec
那部	nguk
嫌贫爱富	vuwv
签合同	twwg
恋母	yoxn
酷睿	sghp
男人装	leww
伊苏	wvae
金河	qqis
自动挡	thfc
腹板	etsr
义马	yrcg
傻人	wtww
金泽	qqic
人参果	wwcd
林妹妹	ssvf
伤者	wtft
义结金兰	yrxf
傻仔	wtwb
祖阿曼	pybs
倒掉	wgrh
人资	wwuq
乐驰	tncg
联调	buym
建阳	vgbj
脆皮	eqhc
避震	nkfd
但系	wjtx
乐高	tnyk
中鼎	khhn
想头	shud
金湖	qqid
书页	nndm
金源	qqid
过节费	fpab
高品质	ykkk
舱单	teul
信息费	wyth
心结	nyxf
焊机	ojsw
焊材	ojsf
五棵松	ggsj
惠山	gjmm
加工费	ekaa
舒城	wffd
亏钱	fnqf
于锐	gfqu
胃胀	leet
云铜	fcqm
育英	ycam
耒阳	dibj
恒源	ngid
腿模	evsa
王力宏	ggen
考题	ftjg
惊悚	nyng
大孩子	ddby
自已	thnn
野熊	jfce
云门	fcuy
四海一家	lhit
恩波	ldih
心脑	nyey
良乡	yvxt
德芙	tfaf
什邡	wfyb
火系	ootx
腿毛	evtf
定军山	pgpl
胡编	dexy
保湿	wkij
翔龙	ugdx
工程设计	aatk
仙踪	wmkh
老驴	ftcg
老马	ftcg
舜天	epgd
恶汉	goic
耳钉	bgqs
烤漆	ofis
金牛	qqtg
信源	wyid
待见	tfmq
彩贝	esmh
五雷	ggfl
野狼	jfqt
金狮	qqqt
彩超	esfh
僧伽	wuwe
侠盗	wguq
取款机	bcff
金猪	qqqt
低脂	wqex
开骂	gakk
肛裂	eagq
舞姬	rlva
泉州市	riyt
张震	xtfd
罗志祥	lqfn
小叮当	ihks
张静	xtge
快线	nnxf
张靖	xtug
金球	qqgg
凯瑟琳	mngg
女儿红	vvqt
实物图	putq
重甲	tglh
配电箱	sgjn
行万里路	tggq
大笨蛋	ddts
橄榄油	snsj
停手	wyrt
肥西	ecsg
金田	qqll
傣妹	wdvf
重症	tgug
金甲	qqlh
郭德纲	yktf
阿迪达斯	bsmp
佳缘	wfxx
自拟	thrn
自拍	thrr
炒粉	oiow
性福	ntpy
恶灵	govo
烤猪	ofqt
赛尔号	paqi
永结同心	ynxf
火舞	oorl
色卡	qchg
驱动精灵	cgfc
德行	tftg
职院	bkbp
色友	qcdc
微视	tmpy
停播	wyrt
自摸	thra
熊怪	cenc
邪魔	ahos
傻女	wtvv
良品	yvkk
傻妞	wtvn
傻妹	wtvf
傻姑	wtvd
绝代双骄	xqwa
烤瓷	ofuq
第三个	txdg
亡魂	ynfc
聂风	bcwr
仿造	wytf
不堪重负	dhfa
花乡	awxt
肉酱	mwuq
炒肉	oimw
大兵小将	ddrg
金税	qqtu
彩钢	esqm
挑战性	rqhk
第一册	txgg
彩钻	esqh
惠来	gjgo
质保金	rfwk
冷酷无情	uwsg
追求者	wngi
麦咖啡	gtke
榨汁机	spif
鉴权	jtsc
艾利和	artj
恋空	yopw
爷们	wrwu
保研	wkdg
脚趾头	efkh
周立波	mfuu
傻帽	wtmh
功能性	aece
重色轻友	tgqc
修真	whfh
灵蛇	vojp
何解	wsqe
色女	qcvv
优酷	wdsg
配货	sgwx
动车组	fclg
慧娟	dhvk
加强版	ekxk
花刺	awgm
情深	ngip
好兄弟	vbkq
绿豆汤	xvgk
炖菜	ogae
代领	wawy
倒班	wggy
芦台	ayck
忠言	khyy
你见	wqmq
先人	tfww
侧脸	wmew
心路	nykh
炫舞	oyrl
正确率	ghdq
光伏	igwd
焊盘	ojte
金线	qqxf
金疮药	qquw
惠氏	gjqa
爱华	epwx
重置	tglf
大客户	ddpt
牛二	tgfg
重考	tgft
第一句	txgg
煤泥	oain
彪马	hacg
炒蛋	oinh
星期几	jtad
第一场	txgg
布娃娃	dmvf
签收单	twnh
舞林	rlss
煲汤	wkin
艾尔	arqi
版务	thte
鄢陵	ghbf
颜如玉	utvk
灰谷	doww
片区	thar
版区	thar
芝士	apfg
安阳市	pvbj
光剑	igwg
苍南	awfm
炼药	oaax
重色	tgqc
能让	ceyh
惊爆	nyoj
全价	wgww
桃之夭夭	sqpp
挑战杯	rqhk
灌醉	iasg
张柏芝	xtsr
志远	fnfq
关乎	udtu
主厂房	ygdg
腰线	esxf
烤翅	offc
六位	ywwu
萧亚轩	avgo
倒票	wgsf
光口	igkk
爱城	epfd
舵机	tesw
金莎	qqai
热缩	rvxp
财务室	mfte
憋尿	umni
爹地	wrfb
烤肠	ofen
第一家	txgg
七言绝句	agyy
第一季	txgg
范伟	aiwf
爱墙	epff
养人	ufww
黑五类	lfgg
堰塞湖	fapa
牛叉	tgcy
体量	wsjg
兽人	ulww
传音	wfuj
修罗	whlq
花姐	awve
内业	mwog
德克萨斯	tfdq
停牌	wyth
酒钢	isqm
借种	watk
倩碧	wggr
余量	wgjg
德隆	tfbt
第三天	txdg
船检	tesw
兮兮	wgwg
舒淇	wfia
色戒	qcaa
特典	tfma
酉阳	sgbj
花嫁	awvp
共军	awpl
爸妈	wrvc
全包	wgqn
中青旅	khge
戏份	caww
傻根	wtsv
傻样	wtsu
自由人	thmh
慕斯	ajad
金蛇	qqjp
慢摇	njre
维尼熊	xwnx
爱词霸	epyn
用户组	ehyn
爱宝	eppg
金蝉	qqju
花屏	awnu
龙骑士	dxcg
版头	thud
洗面奶	itdm
薄情寡义	aing
苏大	aedd
刘炽平	yjok
我倒	trwg
牛场	tgfn
训练营	ykxa
煤电	oajn
茂县	adeg
小可爱	ihsk
火腿肠	ooev
上等人	hgtf
克夫	dqfw
片头曲	thud
茶业	awog
农信	pewy
版子	thbb
八嘎	wtkd
牙套	ahdd
牛头	tgud
顺义区	kdyr
非礼勿视	hdpy
傻比	wtxx
苏宁	aeps
冲上	ukhg
全图	wglt
片尾	thnt
爱建	epvg
内双	mwcc
欢乐谷	cqtn
思达	lndp
思远	lnfq
快闪	nnuw
光宇	igpg
双系统	cctx
冯伟	ucwf
思迪	lnmp
偏科	wytu
量词	jgyn
火雨	oofg
任贤齐	wtjc
古灵精怪	dgvo
光山	igmm
费尽心思	xjny
成周	dnmf
止回阀	hhlk
愚爱	jmep
农办	peew
克山	dqmm
体香	wstj
农化	pewx
油烟机	imol
八天	wtgd
天河城	gdis
舞王	rlgg
有志于此	defn
牛屎	tgno
艾格	arst
兰大	uddd
爆机	ojsw
辅导书	lgnf
冠县	pfeg
慢歌	njsk
八婆	wtih
周笔畅	mftt
倒萨	wgab
大法师	ddif
英孚	ameb
怀集	ndwy
打人	rsww
大河报	ddis
手信	rtwy
刘亦菲	yjyo
打伞	rswu
荣丰	apdh
豆浆机	gkuq
熟男	ykle
八宝	wtpg
煤粉	oaow
重进	tgfj
牟平	ctgu
登记证	wgyn
几两	wtgm
愿赌服输	drmf
兴宁	igps
第一期	txgg
重邮	tgmb
炼金	oaqq
免息	qkth
焊装	ojuf
扣件	rkwt
蛋炒饭	nhoi
驱动盘	cgfc
苦役	adtw
斗地主	uffb
炫铃	oyqw
范尼	ainx
房号	ynkg
傻猪	wtqt
合金弹头	wgqq
茅山	acmm
凑凑	udud
艺海	anit
爱普	epuo
荣光	apig
花月	awee
茶园	awlf
情花	ngaw
梅书慧	stnn
狼人	qtww
春困秋乏	dwls
烟道	olut
花柳	awsq
刀锋山	vnqt
第二场	txfg
花桥	awst
慢热	njrv
出云	bmfc
出仓	bmwb
烟台市	olck
信道	wyut
茌平	awgu
臭脸	thew
金铃	qqqw
光效	igyw
金钻	qqqh
修车	whlg
入戏	tyca
艳照	dhjv
农安	pepv
金锭	qqqp
腿软	evlq
苍月	awee
几双	wtcc
片材	thsf
生死离别	tggq
第三季度	txdg
鼓楼区	fkso
几号	wtkg
心比天高	nyxx
压寨夫人	dfpa
扰动	rdfc
泡泡堂	iqiq
有缘无份	dexx
凤台	wcck
抓人	rrww
高碑店	ykdr
出关	bmud
第二层	txfg
刊例	fjwg
芭比	acxx
凭单	wtul
凡品	wykk
光杆	igsf
再开	gmga
刘丽	yjgm
第二季	txfg
借记	wayn
克林	dqss
小白兔	ihrr
光栅	igsm
茶山	awmm
冰宫	uipk
晚自习	jqth
初二	pufg
报个	rbwh
准奏	uwdw
公摊	wcrc
煎饼果子	ueqn
出单	bmul
中文网	khyy
英文歌	amyy
切刀	avvn
承压	bddf
猪仔	qtwb
花海	awit
牛柳	tgsq
百安居	djpv
色男	qcle
保护膜	wkry
狗头	qtud
慈禧	uxpy
承台	bdck
劲乐团	catn
腰链	esql
倒车	wglg
艾瑞	argm
分包	wvqn
第五届	txgg
喜结连理	fkxf
花溪	awie
冯巩	ucaw
莒南	akfm
茶庄	awof
公明	wcje
兰斯	udad
纯音乐	xguj
人生如梦	wwtg
偷菜	wwae
凤城	wcfd
刘军	yjpl
修正主义	whgh
全服	wgeb
内推	mwrw
马化腾	cgwx
荣威	apdg
小喇叭	ihkg
凉宫	uypk
狼嚎	qtky
倾计	wxyf
特曼	tfjl
特服	tfeb
花火	awoo
抗压	rydf
药妆	axuv
兽族	ulyt
学士服	ipfg
刘华	yjwx
允浩	cqit
有心无力	deny
凤姐	wcve
扭头	rnud
阿拉丁	bsru
红蜻蜓	xajg
人生如戏	wwtg
永不退缩	yndh
列名	gqqk
托尼	rtnx
刘君	yjvt
磨刀石	osvn
犯懒	qtng
菌体	alws
拉人	ruww
凯奇	mnds
范玮琪	aigf
爽歪歪	drdh
抢号	rwkg
舒蕾	wfaf
切图	avlt
删号	mmkg
凡客	wypt
前五	uegg
报号	rbkg
几对	wtcf
舰船	tete
跟屁虫	khnx
内机	mwsw
初唐	puov
剑仙	wgwm
爵爷	elwr
金鹰	qqow
苏澳	aeit
十一五	fggg
自评	thyg
独山	qtmm
大润发	ddiu
船舷	tete
凤岗	wcmm
冲抵	ukrq
肚子痛	efbb
凯子	mnbb
金鼎	qqhn
八步	wthh
纪顺友	xnkd
剑侠	wgwg
肚子疼	efbb
倾述	wxsy
坐台女	wwck
成林	dnss
莉娜	atvn
以智取胜	nytd
制单	rmul
金龟	qqqj
特步	tfhh
摩天轮	osgd
烤鱼	ofqg
把妹	rcvf
拉到	rugc
军曹	plgm
悦铃	nuqw
报团	rblf
拍到	rrgc
护坡	ryfh
花痴	awut
副业	gkog
保卫战	wkbg
刀客	vnpt
战棋	hksa
好利来	vbtj
拖到	rtgc
烧鸭	oalq
司马懿	ngcg
别在	kedh
执念	rvwy
切客	avpt
仙剑四	wmwg
倚靠	wdtf
初夜	puyw
拟写	rnpg
拌合	ruwg
净资产	uquq
犀浦	niig
莲塘	alfo
父皇	wrrg
营养师	apuf
福星高照	pyjt
刘婧	yjvg
保龄	wkhw
爆粗	ojoe
自造	thtf
懒猪	ngqt
楚留香	ssqy
折子	rrbb
光球	iggg
花样男子	awsu
慧聪	dhbu
王东	ggai
上蹿下跳	hgkh
抚宁	rfps
冷月	uwee
预应力	cnoi
凯恩	mnld
纠缠不休	xnxo
冬梅	tust
收银员	nhqv
生无可恋	tgfq
腹黑	etlf
扣扣	rkrk
刘宏	yjpd
挂住	rfwy
凯悦	mnnu
抄底	rioq
几折	wtrr
艺考	anft
王伟	ggwf
老干妈	ftfg
自采	thes
假钱	wnqf
林宥嘉	sspd
扬扬	rnrn
苗疆	alxf
肇事人	yngk
独挡	qtri
狗日	qtjj
莘庄	auof
投币	rwtm
刨子	qnbb
前四	uelh
刺头	gmud
拱北	raux
公版	wcth
六爻	ywrr
片石	thdg
玄冰	yxui
玄冥	yxpj
荆楚	agss
菜场	aefn
光看	igrh
拿刀	wgvn
可怜兮兮	sknw
荣昌	apjj
光着	igug
爆肚	ojef
剃头	uxud
挂到	rfgc
王军	ggpl
内火	mwoo
大海战	ddit
王刚	ggmr
八班	wtgy
刘建	yjvg
第三章	txdg
拉姆	ruvx
六班	ywgy
加仓	ekwb
抄手	rirt
元神	fqpy
抗性	rynt
三聚氰胺	dgbc
冬泉	turi
剑士	wgfg
牙石	ahdg
养狗	ufqt
碧欧泉	grar
傍边	wyep
独显	qtjo
莎拉	airu
匹夫有责	aqfw
王华	ggwx
春心荡漾	dwny
兖矿	ywdo
青花瓷	geaw
凯文	mnyy
兽王	ulgg
推荐信	rwad
挖到	rpgc
猪心	qtny
狂汗	qtif
雪纳瑞	fvxm
几桌	wthj
办公司	ewwc
拍客	rrpt
北斗七星	uxuf
独栋	qtsa
钟华	qkwx
红颜祸水	xaut
阿凡提	bswy
全真	wgfh
莱恩	agld
钢印	qmqg
办公区	ewwc
打款	rsff
小日本	ihjj
招嫖	rvvs
独守空房	qtpf
煮面	ftdm
十七大	fgag
前山	uemm
剪头	ueud
钻具	qhhw
荔波	aeih
剩女	tuvv
护手	ryrt
荣欣	aprq
软件园	lqwt
牛筋	tgte
猪手	qtrt
检查表	swsj
副处	gkth
荔浦	aeig
办卡	ewhg
挂坠	rfbw
铜业	qmog
击杀	gbrs
助剂	egyj
冰灾	uipo
拳套	uddd
一居室	ggnd
铝业	qkog
刷怪	nmnc
茉莉花	agat
拜山	rdmm
凌海	ufit
出柜	bmsa
凑活	udit
铜价	qmww
王城	ggfd
获批	aqrx
荔湾	aeiy
前序	ueoc
手滑	rtim
挂壁	rfnk
爽肤	dref
葛优	ajwd
穿越火线	pwfh
战甲	hklh
版署	thlf
玄天	yxgd
抱抱	rqrq
列数	gqov
别拿	kewg
凌源	ufid
物管	tqtp
冰爽	uidr
惊鸿	nyia
三生三世	dgtg
刘明	yjje
钢坯	qmfd
刘晓	yjja
埃里克森	fcjf
珍兽	gwul
光棍节	igsj
克罗	dqlq
莫斯	ajad
大米饭	ddoy
剧场版	ndfn
圣女果	cfvv
公管	wctp
招录	rvvi
光耦	igdi
全明星	wgje
挡圈	rilu
刀模	vnsa
冥界	pjlw
螺旋藻	jlyt
艾诺	arya
光腚	igep
前戏	ueca
王宏	ggpd
铣刀	qtvn
光膜	igea
莱曼	agjl
美少年	ugit
挡墙	riff
振国	rdlg
牛股	tgew
分次	wvuq
炊沙成饭	oqii
解放碑	qeyt
删档	mmsi
光良	igyv
狒狒	qtqt
入编	tyxy
锁住	qiwy
牛腿	tgev
铁块	qrfn
报检	rbsw
手环	rtgd
入群	tyvt
狗狗	qtqt
六线	ywxf
抱枕	rqsp
刮板	tdsr
孟婆汤	blih
拒接	raru
董卓	athj
六根清净	ywsv
羡慕嫉妒恨	ugaj
球会	ggwf
玄幻	yxxn
入职	tybk
钟山	qkmm
本地网	sgfb
接入点	ruty
音乐盒	ujtn
银剑	qvwg
萝岗	almm
玛尼	gcnx
换区	rqar
犄角旮旯	tdqe
勤力	aken
损友	rkdc
王庆	ggod
王庄	ggof
王座	ggow
傲雪	wgfv
掉价	rhww
锁具	qihw
勤勤	akak
王建	ggvg
阿玛尼	bsgc
手痒	rtuu
王强	ggxk
银华	qvwx
玩完	gfpf
财务部	mfte
出双入对	bmcc
知书达理	tdnn
授信	rewy
排产	rhut
行者无疆	tgft
环宇	gdpg
萧峰	avmt
出火	bmoo
安监局	pvjt
凸点	hghk
刘洋	yjiu
几班	wtgy
凉皮	uyhc
操作工	rkwt
锁匙	qijg
刘涛	yjid
北仓	uxwb
养胃	ufle
石膏板	dgyk
销号	qikg
限量版	bvjg
剁椒	wssh
北体	uxws
包养	qnuf
怒火攻心	vcoo
男儿本色	leqt
菜果	aejs
演讲稿	ipyf
狼狗	qtqt
千千静听	tftf
割接	pdru
尚雯婕	imfy
憨豆	nbgk
出牌	bmth
新华路	uswx
拜月	rdee
接亲	ruus
铁山	qrmm
爱语	epyg
铜套	qmdd
第一课	txgg
戛纳	dhxm
成考	dnft
乐此不彼	tnhx
虚度光阴	haoa
林正英	ssgh
版规	thfw
理县	gjeg
推优	rwwd
包包	qnqn
锁喉	qikw
挂掉	rfrh
军绿	plxv
抗炎	ryoo
莲湖	alid
冰粥	uixo
抹油	rgim
打票	rssf
择机	rcsw
陈慧琳	badh
兰蔻	udap
刘烨	yjow
菲林	ahss
分割线	wvpd
懒觉	ngip
张娜拉	xtvn
大结局	ddxf
潘玮柏	itgf
西祠胡同	sgpy
戒色	aaqc
猛犸	qtqt
铜山	qmmm
北医	uxat
铺头	qgud
玄晶	yxjj
珠子	grbb
茜茜	asas
北口	uxkk
挡拆	rirr
人文学院	wwyy
英国人	amlg
挺快	rtnn
投球	rwgg
玄月	yxee
菜汤	aein
十位	fgwu
王晓	ggja
十余	fgwg
锁头	qiud
王晶	ggjj
升仙	tawm
第二节	txfg
刘玉	yjgy
华为	wxyt
挂板	rfsr
注射液	iytm
狗粮	qtoy
前海	ueit
王朔	ggub
挂架	rfek
拓海	rdit
泰安市	dwpv
阴阳师	bebj
匹克	aqdq
揍你	rdwq
王杰	ggso
猫猫	qtqt
挖方	rpyy
玉柴	gyhx
回拨卡	lkrn
瑞丰	gmdh
球头	ggud
班导	gynf
挂档	rfsi
铁手	qrrt
蒂娜	ayvn
南乡	fmxt
报班	rbgy
博主	fgyg
博乐	fgtn
蓄力	ayen
单件	ulwt
陈冠希	bapf
爆音	ojuj
出票	bmsf
插值	rtwf
副歌	gksk
北园	uxlf
挑染	rqiv
锅子	qkbb
护甲	rylh
钢构	qmsq
刀神	vnpy
加时	ekjf
锦城	qrfd
锁屏	qinu
钢柱	qmsy
北城	uxfd
出窍	bmpw
漂流瓶	isiy
卡位	hgwu
华军	wxpl
独角兽	qtqe
北塔	uxfa
卫东	bgai
分票	wvsf
北塘	uxfo
猪瘟	qtuj
蓝军	ajpl
蓝冰	ajui
入货	tywx
千千	tftf
北外	uxqh
十名	fgqk
南关	fmud
蓝剑	ajwg
锁帖	qimh
冰蓝	uiaj
援交	reyw
战衣	hkye
博兴	fgig
刮痕	tduv
挖槽	rpsg
大小非	ddih
半只	ugkw
宇智波	pgtd
出糗	bmot
共赢	awyn
铜排	qmrh
卡农	hgpe
蓟县	aqeg
单县	uleg
匡威	agdg
单反	ulrc
单双	ulcc
丁字裤	sgpb
信用度	wyeh
中石油	khdg
通讯费	ceyn
单台	ulck
南县	fmeg
单名	ulqk
北安	uxpv
锡山	qjmm
卫兰	bgud
锐度	quoa
无力回天	fqen
卡勒	hgak
物权法	tqsc
卖呆	fnks
献祭	fmwf
机器猫	swkk
刻盘	ynte
包年	qnrh
充钱	ycqf
北山	uxmm
机顶盒	swsd
战警	hkaq
卡友	hgdc
菜瓜	aerc
玛法	gcif
猪窝	qtpw
兴达	igdp
锐志	qufn
出群	bmvt
草蜢	ajjb
审批表	pjrx
托蒂	rtay
大黄蜂	ddam
锁扣	qirk
拉着	ruug
北川	uxkt
削皮	iehc
房补	ynpu
环比	gdxx
搞事	rygk
美宝莲	ugpg
铝板	qksr
环氧	gdrn
爱驹	epcg
特里	tfjf
南坪	fmfg
拜登	rdwg
运营部	fcap
拖着	rtug
北影	uxjy
探底	rpoq
副理	gkgj
刘红	yjxa
现浇	gmia
王燕	ggak
萨满	abia
吴克群	kgdq
数字键	ovpb
南塔	fmfa
实话实说	puyt
球探	ggrp
好男人	vble
刻章	ynuj
刘成敏	yjdn
南墙	fmff
扑街	rhtf
创维	wbxw
战车	hklg
狗血	qttl
钢炼	qmoa
钢炮	qmoq
折翼	rrnl
凯蒂	mnay
好男儿	vble
换枪	rqsw
八钢	wtqm
公钥	wcqe
刘翔	yjug
牛鞭	tgak
爱丽丝	epgm
班服	gyeb
钙片	qgth
分舵	wvte
遥控器	errp
挖煤	rpoa
拦着	ruug
果粒橙	jsou
午安	tfpv
银松	qvsw
掐指	rqrx
记录表	ynvi
黄玫瑰	amgt
钢牙	qmah
华安	wxpv
华宇	wxpg
拳皇	udrg
华宁	wxps
华宅	wxpt
最终版	jbxt
不小于	dhih
镇平	qfgu
卡奴	hgvc
七星瓢虫	agjt
搏命	rgwg
半岁	ugmq
护肩	ryyn
利群	tjvt
六院	ywbp
房贷	ynwa
拒签	ratw
八零	wtfw
南孚	fmeb
县令	egwy
兰陵	udbf
南安	fmpv
卓尔	hjqi
叁仟	cdwt
南家	fmpg
扫街	rvtf
原包	drqn
拟稿	rnty
球服	ggeb
挤爆	ryoj
摆件	rlwt
乱弹琴	tdxu
原单	drul
牛骨	tgme
懒鬼	ngrq
原卡	drhg
推手	rwrt
钢球	qmgg
人烟稀少	wwol
控制柜	rprm
率先垂范	yxtf
搬动	rtfc
十张	fgxt
钥匙扣	qejg
铁炉	qroy
勒沃	akit
与子偕老	gnbb
阴盛阳衰	bedn
全频	wghh
换歌	rqsk
南岗	fmmm
双井	ccfj
博山	fgmm
八项	wtad
卡宴	hgpj
托词	rtyn
卡密	hgpn
摘下	rygh
厨卫	dgbg
卡尼	hgnx
蓝带	ajgk
历城	defd
卡屏	hgnu
掌机	ipsw
内防	mwby
蓝底	ajoq
北新	uxus
凯西	mnsg
单带	ulgk
锚杆	qasf
年休假	rhws
华强	wxxk
电吉他	jnfk
死无全尸	gqfq
朝九晚五	fjvt
大美女	ddug
排架	rhek
抄表	rige
非诚勿扰	hdyd
银沙	qvii
博库	fgol
锁死	qigq
王磊	ggdd
蓝心	ajny
例行公事	wgtg
卡巴	hgcn
挠痒	rauu
长山	tamm
闲云	usfc
披萨	rhab
双儿	ccqt
挂科	rftu
副管	gktp
扣费	rkxj
银海	qvit
千户	tfyn
抹茶	rgaw
卷尺	udny
迷迭香	oprw
双刀	ccvn
北校	uxsy
凯诺	mnya
去呀	fcka
反制	rcrm
北桥	uxst
海贼王	itma
银湖	qvid
挡着	riug
接机	rusw
第二集	txfg
战靴	hkak
投行	rwtg
萤石	apdg
破财免灾	dhmf
内饰	mwqn
前脸	ueew
蔡妍	awvg
摇号	rekg
卫康	bgov
女生节	vvtg
揉捏	rcrj
王立	gguu
玉符	gytw
哥布林	skdm
美容觉	ugpw
思密达	lnpn
钟离	qkyr
菱纱	afxi
长庆	taod
挨着	rcug
厄尔	dbqi
台企	ckwh
双卡	cchg
叉叉	cycy
鼎力相助	hnen
阀体	uwws
北楼	uxso
长弓	taxn
函证	biyg
卖房	fnyn
减重	udtg
生意兴隆	tguj
茶陵	awbf
傻孩子	wtby
厦大	dddd
古冶	dguc
猪血	qttl
南拳	fmud
小眼睛	ihhv
单排	ulrh
华擎	wxaq
管理器	tpgj
半斤	ugrt
莫言	ajyy
掉渣	rhis
华政	wxgh
成功学	dnae
刑诉	gayr
挂级	rfxb
分货	wvwx
瓯北	arux
阿拉蕾	bsru
战魂	hkfc
捂着	rgug
挂绳	rfxk
北汽	uxir
甚么	adtc
掉漆	rhis
华星	wxjt
台办	ckew
草雉	ajtd
打钱	rsqf
打钩	rsqq
华晨	wxjd
撑住	riwy
铭瑄	qqgp
蓝星	ajjt
刘谦	yjyu
凑钱	udqf
军魂	plfc
半期	ugad
锦涛	qrid
抽血	rmtl
援护	rery
发圈	ntlu
划账	ajmt
瑞昌	gmjj
半杯	ugsd
加内特	ekmw
闽台	ujck
双城	ccfd
南星	fmjt
内黄	mwam
蓝月	ajee
瑞景	gmjy
报读	rbyf
华林	wxss
北湖	uxid
蓝条	ajts
闪图	uwlt
菲菲	ahah
单本	ulsg
蓝染	ajiv
提档	rjsi
吊具	kmhw
北滘	uxip
凉面	uydm
北漂	uxis
刀郎	vnyv
分选	wvtf
南村	fmsf
田东	llai
阶乘	bwtu
博朗	fgyv
吧主	kcyg
卸掉	rhrh
娃哈哈	vfkw
吉列	fkgq
瀑布汗	ijdm
捡的	rwrq
小破孩	ihdh
田亮	llyk
千橡	tfsq
荥阳	apbj
排烟	rhol
南校	fmsy
如意郎君	vkuj
阿三	bsdg
启东	ynai
报关员	rbud
南桥	fmst
铁粉	qrow
去屑	fcni
劈腿	nkev
几门	wtuy
密保卡	pnwk
摆客	rlpt
缩头乌龟	xpud
人走茶凉	wwfh
附一	bwgg
卡板	hgsr
猪蹄	qtkh
发威	ntdg
变天	yogd
阻住	bewy
县局	egnn
男仔	lewb
战龙	hkdx
功名利禄	aeqk
琅琅	gygy
王英	ggam
阿伦	bsww
附二	bwfg
狮驼岭	qtcg
招行	rvtg
蒙版	apth
蒙牛	aptg
凝露	uxfk
男佣	lewe
加群	ekvt
南楼	fmso
双安	ccpv
打饭	rsqn
阿信	bswy
防具	byhw
陈仓	bawb
闪婚	uwvq
搜房	reyn
萍萍	aiai
手骨	rtme
陈伟	bawf
王菲	ggah
打回原形	rslk
台城	ckfd
吐司	kfng
铁线	qrxf
落红	aixa
王蒙	ggap
台塑	ckub
铝管	qktp
凯隆	mnbt
锅盔	qkdo
撇嘴	rukh
吻你	kqwq
陈俊	bawc
几顿	wtgb
上海人	hgit
卷材	udsf
闪字	uwpb
水元素	iifq
卷板	udsr
西铁城	sgqr
萝莉	alat
锁码	qidc
海豚音	iteg
华泰	wxdw
北环	uxgd
叛将	uguq
阿凯	bsmn
搜搜	rere
蒸煮	abft
吃坏	ktfd
蓝波	ajih
闪屏	uwnu
刺身	gmtm
台妹	ckvf
冰龙	uidx
华海	wxit
限值	bvwf
电务	jnte
南汽	fmir
华润	wxiu
吸光	kbig
南河	fmis
双底	ccoq
棒棒堂	sdsd
南泉	fmri
瑞泰	gmdw
千纸鹤	tfxq
探班	rpgy
吧友	kcdc
吊坠	kmbw
男包	leqn
齿轮油	hwlw
叨客	kvpt
双开	ccga
南浔	fmiv
连接数	lpru
南浦	fmig
聪明绝顶	buje
北电	uxjn
阿卡	bshg
蔡明	awje
劫色	fcqc
狮驼	qtcg
陈力	baen
降分	btwv
加菲	ekah
搜易	rejq
分集	wvwy
台安	ckpv
招财	rvmf
长歌	task
锡盟	qjje
叉烧包	cyoa
双性	ccnt
排着	rhug
阿呆	bsks
南湾	fmiy
玛拉顿	gcru
南溪	fmie
界别	lwke
阜外	wnqh
吧嗒	kcka
变径	yotc
制作人	rmwt
国难当头	lgcw
莱钢	agqm
报错	rbqa
狼骑	qtcg
蓝灯	ajos
右岸	dkmd
吴哲	kgrr
原曲	drma
分项	wvad
打鼾	rsth
卷毛	udtf
藏区	adar
原机	drsw
原材	drsf
阳城	bjfd
劲舞团	carl
外联部	qhbu
双扣	ccrk
双抗	ccry
北碚	uxdu
院办	bpew
潜力股	ifen
生姜	tgug
反抽	rcrm
排程	rhtk
插片	rtth
折页	rrdm
阿土	bsff
阜宁	wnps
闲情	usng
铜芯	qman
推荐表	rwad
刷钱	nmqf
双控	ccrp
换股	rqew
清洗剂	igit
阿城	bsfd
刘若英	yjad
蓝狐	ajqt
北科	uxtu
别院	kebp
水煮鱼	iift
加血	ektl
降噪	btkk
侠客行	wgpt
银翼	qvnl
瑞特	gmtf
炎亚纶	oogo
爱慕虚荣	epaj
蓝猫	ajqt
陈坚	bajc
拿货	wgwx
陈坤	bafj
押镖	rlqs
珈蓝	geaj
藁城	ayfd
藤县	aeeg
剧透	ndtb
北站	uxuh
闲扯	usrh
听她	krvb
陪吃	bukt
抓鬼	rrrq
双敏	cctx
咳咳咳	kyky
南环	fmgd
第六个	txyw
换色	rqqc
味全	kfwg
阳子	bjbb
刺陵	gmbf
阿姆	bsvx
牛魔王	tgos
蓝瓶	ajua
华电	wxjn
阿娜	bsvn
理综	gjxp
阿娇	bsvt
抹面	rgdm
葬花	agaw
勾缝	qcxt
低音炮	wquj
女明星	vvje
拼车	rulg
南瑞	fmgm
阜康	wnov
涅米宁	ijoy
电光火石	jnig
捧花	rdaw
陈好	bavb
甩尾	ennt
取整	bcgk
陈妍	bavg
班花	gyaw
全智贤	wgtd
呼兰	ktud
发春	ntdw
幸运草	fufc
来来去去	gogo
银英	qvam
陈威	badg
双月	ccee
挂载	rffl
后弦	rgxy
班草	gyaj
定时器	pgjf
阿宝	bspg
日有所思	jjde
男宠	lepd
蓝白	ajrr
前阵	uebl
阿尔	bsqi
陶喆	bqfk
蓝盾	ajrf
锁芯	qian
山寨机	mmpa
双核	ccsy
陆家	bgpg
吴尊	kgus
甩干	enfg
博白	fgrr
陈家	bapg
匪类	ahod
瑶瑶	gege
呱唧	krkv
蕲春	audw
吸尘	kbif
厂牌	dgth
双楠	ccsf
拉风	ruwr
片尾曲	thnt
呷哺	klkg
夜不归宿	ywdh
落课	aiyj
男巫	leaw
除妖	bwvt
阿布	bsdm
半秒	ugti
劫财	fcmf
拌饭	ruqn
华科	wxtu
防恐	byaw
攻丝	atxx
蒙自	apth
包茎	qnac
宽衣解带	paye
瑞祥	gmpy
番外	toqh
隆回	btlk
台服	ckeb
踏雪无痕	khfv
华立	wxuu
加送	ekud
使命召唤	wgwg
键能	qvce
陈建	bavg
拿铁	wgqr
玄铁	yxqr
屈臣氏	nbah
波纹管	ihxy
台架	ckek
彼此彼此	thhx
杜蕾斯	sfaf
画心	glny
摩天大楼	osgd
双汇	ccia
故交	dtyw
台标	cksf
挂链	rfql
撒播	rart
多措并举	qqra
半米	ugoy
南站	fmuh
双河	ccis
虐人	haww
原片	drth
陈忠	bakh
北苑	uxaq
陈志	bafn
肌肉男	ewmw
剔骨	jqme
玩酷	gfsg
吊旗	kmyt
夜不能寐	ywdh
反派	rcir
剑魂	wgfc
逍遥叹	ieer
雅克	ahdq
品保	kkwk
链表	qlge
随堂	bdip
名族	qkyt
防损	byrk
压痕	dfuv
痛了	ucbn
订单号	ysul
双性恋	ccnt
压盘	dfte
吓晕	kgjp
收卷	nhud
咁好	kavb
吊柜	kmsa
电控	jnrp
压着	dfug
拉黑	rulf
咩咩	kuku
卡类	hgod
吻戏	kqca
劲量	cajg
瓯江	aria
雄县	dceg
原电	drjn
攸县	wheg
散人	aeww
玄风	yxwr
队标	bwsf
掉血	rhtl
后桥	rgst
包袋	qnwa
沙坪坝	iifg
副高	gkyk
厚皮	djhc
捡起来	rwfh
咳咳	kyky
哈利	kwtj
加锁	ekqi
隆尧	btat
哑光	kgig
号段	kgwd
可没	skiw
寻秦记	vfdw
雷人	flww
华联	wxbu
锐角	quqe
叽歪	kwdh
博罗	fglq
阿斯	bsad
华能	wxce
博美	fgug
雪儿	fvqt
阿旺	bsjg
蒂诺	ayya
撤柜	rysa
闽清	ujig
阿星	bsjt
搞砸	ryda
闪灯	uwos
回合制	lkwg
虚化	hawx
华腾	wxeu
单肩	ulyn
卸妆油	rhuv
隔层	bgnf
玉髓	gyme
雀圣	iwcf
雷傲	flwg
铂锐	qrqu
同款	mgff
隆平	btgu
绥芬河	xeaw
锅贴	qkmh
电板	jnsr
华艺	wxan
阿杜	bssf
哇哦	kfkt
蒸蛋	abnh
陈晓	baja
哎呦	kakx
中国风	khlg
良苦用心	yvad
雁塔	dwfa
卤肉	hlmw
第八届	txwt
吧椅	kcsd
同求	mggi
雅培	ahfu
哈喽	kwko
尼古拉斯	nxdg
哇嘎	kfkd
蓝莓	ajat
南苑	fmaq
落雪	aifv
销轴	qilm
华菱	wxaf
长老	taft
取现	bcgm
周渝民	mfiw
厨神	dgpy
劲霸	cafa
长肉	tamw
后海	rgit
纸飞机	xqnu
随性	bdnt
捐钱	rkqf
铃音	qwuj
唐人	ovww
北语	uxyg
雾化	ftwx
零号	fwkg
勇闯	ceuc
孤男寡女	brle
王鹏	ggee
黑芝麻	lfap
瓷片	uqth
哪只	knkw
唔会	kgwf
数名	ovqk
哦哟	ktkx
虎妞	havn
阿武	bsfh
妮维雅	vnxw
虞城	hafd
小马哥	ihcg
精舞门	ogrl
玉龙	gydx
集宁	wyps
触手可及	qert
瑞虎	gmha
陈欣	barq
收尸	nhnn
咒怨	kkqb
计划表	yfaj
湖南台	idfm
哈姆	kwvx
台班	ckgy
安装版	pvuf
启动项	ynfc
变盘	yote
随拍	bdrr
陆毅	bgue
甲流	lhiy
电法	jnif
新乐	ustn
闭着	ufug
半裸	ugpu
观察室	cmpw
哀家	ykpg
吹水	kqii
文县	yyeg
斥候	rywh
吴波	kgih
蓝衣	ajye
方向键	yytm
鸡同鸭讲	cqmg
唇印	dfqg
哼哈	kykw
台电	ckjn
虞姬	hava
文君	yyvt
午觉	tfip
蓝装	ajuf
闲着	usug
名爵	qkel
捞面	radm
雪女	fvvv
卤蛋	hlnh
吴淞	kgis
陈涛	baid
哈尔	kwqi
哨塔	kifa
魔法师	osif
北邮	uxmb
质监局	rfjt
朝夕相处	fjqt
唐县	oveg
陕汽	bgir
镇赉	qfgo
唉哟	kckx
捉鬼	rkrq
锻炼身体	qwoa
甄子丹	sfbb
股东会	ewai
攻强	atxk
霸刀	favn
琳达	gsdp
改性	ntnt
第六条	txyw
吊瓶	kmua
华讯	wxyn
连接线	lpru
羊肉串	ugmw
咋整	ktgk
掉钱	rhqf
卫衣	bgye
效度	ywoa
发簪	ntta
安装盘	pvuf
隐杀	bqrs
预付费	cnwf
证件照	ygwt
涂鸦板	iwah
电煤	jnoa
商位	yuwu
长衫	tapu
阻燃	beoq
雷子	flbb
留海	qyit
哈弗	kwxj
痱子	uhbb
斗嘴	ufkh
咏春	kydw
大酒店	ddis
听牌	krth
疯掉	uwrh
原药	drax
新历	usde
唐国	ovlg
阿牛	bstg
生生	tgtg
男版	leth
口算	kkth
后的	rgrq
陶氏	bqqa
阿狸	bsqt
蒙阴	apbe
田忌赛马	llnn
唠嗑	kakf
爱丽舍	epgm
蛮久	yoqy
北镇	uxqf
相思树	shln
捕鸟	rgqy
副校长	gksy
周波	mfih
商函	yubi
修改器	whnt
疾控	utrp
酸菜鱼	sgae
日企	jjwh
集控	wyrp
田甜	lltd
旧件	hjwt
叶子板	kfbb
华软	wxlq
无保	fqwk
卡费	hgxj
卡贴	hgmh
采购单	esmq
双联	ccbu
阿瑟	bsgg
蛋卷	nhud
北院	uxbp
青协	gefe
北陵	uxbf
散弹	aexu
陈玉	bagy
早会	jfwf
啤酒节	kris
双胞	cceq
阿甘	bsaf
霍尔	fwqi
青县	geeg
青口	gekk
卖车	fnlg
合租	wgte
唔好	kgvb
陈瑞	bagm
甪直	tefh
哈拉	kwru
品控	kkrp
华邦	wxdt
霍山	fwmm
商友	yudc
百丽	djgm
藏獒	adgq
新地	usfb
百乐	djtn
博达	fgdp
蛮像	yowq
雷德	fltf
汇总表	iauk
发腻	nted
电白	jnrr
艺术字	ansy
亢龙有悔	ywdx
旺仔	jgwb
双色	ccqc
南邮	fmmb
文峰	yymt
蛮兵	yorg
无刷	fqnm
南郡	fmvt
易语言	jqyg
靠后	tfrg
营销部	apqi
霸天	fagd
吻痕	kquv
旭光	vjig
单重	ultg
露娜	fkvn
方城	yyfd
天干物燥	gdfg
提供商	rjwa
呆瓜	ksrc
南里	fmjf
文帝	yyyu
接风	ruwr
昌乐	jjtn
登入	wgty
方士	yyfg
口臭	kkth
面善	dmug
百兆	djqi
摘菜	ryae
数码宝贝	ovdc
右耳	dkbg
青城	gefd
精疲力尽	oguh
大开方便之门	ddga
提钱	rjqf
虎林	hass
右肩	dkyn
阿福	bspy
藏着	adug
唇彩	dfes
含税	wytu
青塔	gefa
通达信	cedp
华银	wxqv
蓝钻	ajqh
蛇女	jpvv
蛇妖	jpvt
古荡	dgai
皇军	rgpl
瓦萨	gnab
甭管	dhtp
南钢	fmqm
锦鲤	qrqg
某某某	afaf
留白	qyrr
啮合	khwg
华阳	wxbj
工作餐	aawt
春丽	dwgm
靓妞	gevn
阀芯	uwan
小坏蛋	ihfd
虫族	jhyt
下载器	ghfl
热情似火	rvng
蓝队	ajbw
电箱	jnts
终成眷属	xtdn
非处	hdth
啫喱	kfkd
霸州	fayt
蓝雪	ajfv
南院	fmbp
申精	jhog
南陵	fmbf
阿米	bsoy
陪睡	buht
南雄	fmdc
泰罗卡	dwlq
骨灰级	medo
卡门	hguy
生者	tgft
新平	usgu
阿紫	bshx
雷曼	fljl
明华	jewx
普罗旺斯	uolq
喜儿	fkqt
铭记于心	qqyn
无头	fqud
整晚	gkjq
狼图腾	qtlt
公私分明	wctc
火星人	oojt
原车	drlg
震旦	fdjg
春兰	dwud
变装	youf
易县	jqeg
男同胞	lemg
神秘园	pytn
午马	tfcg
任意球	wtuj
留空	qypw
赵子龙	fhbb
门襟	uypu
章子怡	ujbb
名苑	qkaq
闺蜜	ufpn
阿维	bsxw
时域	jffa
虾条	jgts
毕业照	xxog
青川	gekt
闵行	uytg
痛死	ucgq
陈红	baxa
上辈子	hghd
白塔	rrfa
无字	fqpb
维修点	xwwh
鞋城	akfd
长靴	taak
反语	rcyg
小高层	ihyk
反调	rcym
蓝魔	ajos
皇城	rgfd
飞火流星	nuoo
盘中	tekh
百天	djgd
雍和宫	yxtk
皮卡	hchg
昌图	jjlt
费迪南德	xjmp
陈翔	baug
反贼	rcma
晒伤	jswt
鞋套	akdd
谆谆教导	yyyy
蓝鲸	ajqg
小学同学	ihip
春哥	dwsk
早生贵子	jftg
有线通	dexf
志士仁人	fnfg
上下九	hggh
电芯	jnan
皇姑	rgvd
智能机	tdce
整死	gkgq
白宁	rrps
雷法	flif
华鹏	wxee
陶粒	bqou
晚修	jqwh
电瓶车	jnua
下辈子	ghhd
盂县	gfeg
陈艳	badh
阿莲	bsal
斜杠	wgsa
生蚝	tgjt
咱班	ktgy
飞行岛	nutg
白屏	rrnu
生蛋	tgnh
蓝黑	ajlf
无影	fqjy
高风亮节	ykwr
蛋挞	nhrd
华侨城	wxwt
日式	jjga
快乐男声	nntn
阿萨	bsab
虚焊	haoj
郭敬明	ykaq
病猫	ugqt
新新	usus
后补	rgpu
阿蒙	bsap
陈莉	baat
取车	bclg
大乐透	ddtn
原阳	drbj
监区	jtar
喵喵	kaka
蛮快	yonn
合规	wgfw
厌食	ddwy
明子	jebb
直供	fhwa
陪聊	bubq
新服	useb
周线	mfxf
吉娃娃	fkvf
撞衫	rupu
松嫩平原	swvg
时延	jfth
易宝	jqpg
盗号	uqkg
晋商	goyu
皮套	hcdd
鸡毛掸子	cqtf
擦肩	rpyn
易居	jqnd
克难攻坚	dqcw
导购员	nfmq
雾灯	ftos
喜字	fkpb
雪狐	fvqt
雪狼	fvqt
嗾使	kywg
喷塑	kfub
蔡骏	awcg
阳西	bjsg
星尘	jtif
摊铺	rcqg
阿衰	bsyk
青木	gess
虚拟机	harn
霞浦	fnig
鞭尸	aknn
双钻	ccqh
男裤	lepu
旋木	ytss
虎眼	hahv
胡图族	delt
哈皮	kwhc
发钱	ntqf
痘痘	ugug
擦药	rpax
直发	fhnt
普吉	uofk
装箱单	ufts
暑促	jfwk
白手	rrrt
隐者	bqft
数独	ovqt
明心	jeny
四叶草	lhkf
商校	yusy
双门	ccuy
阿隆索	bsbt
双阳	ccbj
限行	bvtg
陇西	bdsg
吃辣	ktud
吓跑	kgkh
白拿	rrwg
痤疮	uwuw
仰卧起坐	wqah
金士顿	qqfg
反震	rcfd
闲钱	usqf
周董	mfat
省台	itck
甩货	enwx
盖头	ugud
太平门	dygu
虾球	jggg
五福临门	ggpy
小魔女	ihos
复兴门	tjig
真像	fhwq
日服	jjeb
闹铃	uyqw
验收单	cgnh
景园	jylf
旁氏	yuqa
无框	fqsa
厚黑	djlf
皮影	hcjy
无梦	fqss
嗷嗷	kgkg
新源	usid
无棣	fqsv
发飚	ntwr
旺旺	jgjg
包装袋	qnuf
免费版	qkxj
勤学好问	akip
百晓	djja
队里	bwjf
斗牛	uftg
虚竹	hath
星战	jthk
相城	shfd
收红	nhxa
商河	yuis
收线	nhxf
暮光	ajig
分久必合	wvqy
皇明	rgje
反骨	rcme
旧楼	hjso
阳逻	bjlq
车友会	lgdc
叶问	kfuk
发骚	ntcg
嘎啦	kdkr
韩寒	fjpa
花开富贵	awga
售点	wyhk
阿达	bsdp
暴兵	jarg
放线	ytxf
无欲	fqww
红太阳	xady
鞋架	akek
阿迪	bsmp
蛟河	jyis
修改版	whnt
瘦猴	ueqt
盖州	ugyt
嘎嘎	kdkd
上海话	hgit
嘉园	fklf
雨篷	fgtt
附送	bwud
双鱼	ccqg
陈辰	badf
海底捞	itoq
新片	usth
盘库	teol
普宁	uops
萨摩耶	abos
嘘嘘	khkh
合阳	wgbj
恐高症	awyk
阿金	bsqq
哈罗	kwlq
散粉	aeow
步步高	hhhh
限选	bvtf
合集	wgwy
韩庚	fjov
整站	gkuh
嘟嘟	kfkf
方特	yytf
拉肚子	ruef
双鹤	ccpw
孰轻孰重	yklc
星晴	jtjg
收益率	nhuw
呆过	ksfp
韩式	fjga
双黄	ccam
皮料	hcou
爱仕达	epwf
日清	jjig
嘶吼	kakb
参天大树	cdgd
顺丰	kddh
邮寄费	mbpd
火星文	oojt
此情可待	hxng
收菜	nhae
限重	bvtg
月亮石	eeyk
百汇	djia
白沙	rrii
黄晓明	amja
文字链	yypb
威廉姆斯	dgou
嘻哈	kfkw
蛊王	jlgg
双节棍	ccab
胡子拉碴	debb
艺术系	ansy
嘿咻	klkw
电锤	jnqt
零线	fwxf
台湾人	ckiy
嘉实	fkpu
七年级	agrh
艺术类	ansy
春梅	dwst
制作费	rmwt
痴线	utxf
蛮灵	yovo
自甘堕落	thaf
父亲节	wrus
蝶恋	jayo
哈药	kwax
明水	jeii
青田	gell
昌河	jjis
更像	gjwq
无爱	fqep
无牌	fqth
雪舞	fvrl
随货	bdwx
阿雅	bsah
附院	bwbp
浅蓝色	ifaj
震级	fdxb
睢县	hweg
阿雪	bsfv
只字未提	kwpb
月付	eewf
画集	glwy
黑山老妖	lfmm
男鞋	leak
蛮牛	yotg
嘉应	fkoi
拉丁舞	rusg
瞎侃	hpwk
百炼	djoa
路人甲	khww
陈静	bage
明湖	jeid
文综	yyxp
唔系	kgtx
男大当婚	ledd
日班	jjgy
真巧	fhag
敷脸	geew
真帅	fhjm
毕业证	xxog
暗度	juoa
防高	byyk
画风	glwr
望京	ynyk
韩星	fjjt
鹿鼎记	onhn
蝙蝠侠	jyjg
白牛	rrtg
双手剑	ccrt
无疆	fqxf
百特	djtf
文聘	yybm
电驴	jncg
曹县	gmeg
登门拜访	wguy
靠着	tfug
降频	bthh
嘉惠	fkgj
白狐	rrqt
输送机	lwud
电骡	jncg
白狼	rrqt
通过率	cefp
星湖	jtid
情何以堪	ngws
卡罗拉	hglq
陈香	batj
噢噢	ktkt
韩服	fjeb
好聚好散	vbbc
晨早	jdjf
看房	rhyn
皇牌	rgth
转接头	lfru
晓梦	jass
亏心事	fnny
方管	yytp
好事成双	vbgk
维修费	xwwh
白班	rrgy
金水区	qqii
雪蛤	fvjw
白球	rrgg
旁站	yuuh
手下败将	rtgh
月卡	eehg
后备箱	rgtl
略阳	ltbj
附魔	bwos
雨蝶	fgja
曾哥	ulsk
字幕组	pbaj
蛋筒	nhtm
嗨曲	kima
无码	fqdc
斩立决	lruu
放话	ytyt
林心如	ssny
暗战	juhk
暖手	jert
霍营	fwap
降魔	btos
隆鑫	btqq
蛇精	jpog
非空	hdpw
有哦	dekt
防晒霜	byjs
喷淋	kfis
暴强	jaxk
彩虹岛	esja
页头	dmud
无神	fqpy
秦时明月	dwjf
攀钢	srqm
普桑	uocc
世纪城	anxn
预埋	cnfj
白皮	rrhc
白盒	rrwg
雪见	fvmq
漫步者	ijhh
百盛	djdn
春熙	dwah
白眉	rrnh
风伯	wrwr
盾构	rfsq
面签	dmtw
睢宁	hwps
春燕	dwak
曼城	jlfd
嘉敏	fktx
美特斯邦威	ugtf
邹小旻	qvih
李东	sbai
日租	jjte
李丽	sbgm
断背	onux
期号	adkg
李云	sbfc
白石	rrdg
荒山野岭	aymm
虎跃	hakh
白矾	rrdw
凯立德	mnuu
一体机	ggws
心力衰竭	nyen
频域	hhfa
青红	gexa
皮特	hctf
盛泽	dnic
瞬发	hent
有型	dega
分析师	wvsr
双色球	ccqc
李佳	sbwf
顺子	kdbb
虚拟网	harn
李俊	sbwc
暖春	jedw
攻速	atgk
台州市	ckyt
飞信	nuwy
李健	sbwv
百福	djpy
无糖	fqoo
降龙	btdx
补休	puws
暗月	juee
藿香	aftj
四件	lhwt
新茶	usaw
春生	dwtg
星痕	jtuv
日系	jjtx
集采	wyes
四位	lhwu
月姬	eeva
李兵	sbrg
敬语	aqyg
散货	aewx
相求	shgi
皮甲	hclh
李凤	sbwc
衰人	ykww
韶涵	ujib
李刚	sbmr
杜健	sfwv
胡编乱造	dexy
马天宇	cggd
月嫂	eeve
皮痒	hcuu
飞到	nugc
昂立	jquu
额娘	ptvy
新蓝	usaj
李勇	sbce
下一次	ghgg
补光	puig
星矢	jttd
旋舞	ytrl
青苗	geal
雨辰	fgdf
矿上	dohg
大喊大叫	ddkd
监督局	jthg
无暇顾及	fqjn
残奥会	gqtm
图一	ltgg
杨光	snig
李咏	sbky
格尔木	stqi
李哥	sbsk
螺柱	jlsy
韩版	fjth
补单	puul
收阅	nhuu
蛋白粉	nhrr
看海	rhit
百纳	djxm
短剑	tdwg
四厂	lhdg
性伴侣	ntwu
杞县	sneg
宋祖英	pspy
四叔	lhhg
四只	lhkw
四台	lhck
无良	fqyv
供应部	waoi
白羊	rrug
表名	geqk
题干	jgfg
合家幸福	wgpg
蜜粉	pnow
杨卫	snbg
万能充	gqce
喷码	kfdc
李四	sblh
哇哈哈	kfkw
百联	djbu
短号	tdkg
杆塔	sffa
霉运	ftfc
风大	wrdd
斯柯达	adss
蜂胶	jtey
糖醋鱼	oosg
雅顿	ahgb
本尊	sgus
明线	jexf
大兴区	ddig
比亚迪	xxgo
鲅鱼圈	qgqg
政风	ghwr
蛛蛛	jrjr
祝福语	pypy
李天	sbgd
李奇	sbds
白花	rraw
图区	ltar
盈科	bctu
码号	dckg
圣代	cfwa
暴汗	jaif
餐卡	hqhg
村妓	sfvf
晋祠	gopy
李娜	sbvn
看片	rhth
景田	jyll
破书	dhnn
顺昌	kdjj
图名	ltqk
杆子	sfbb
本店	sgoh
对对碰	cfcf
风轻云淡	wrlc
长江路	taia
土偶	ffwj
星美	jtug
砸人	daww
百脑汇	djey
四天	lhgd
盯盘	hste
圈友	ludc
补妆	puuv
双截棍	ccfw
李宇	sbpg
李安	sbpv
张小龙	xtih
萧敬腾	avaq
皮绳	hcxk
哪门	knuy
四姐	lhve
暗爽	judr
圣光	cfig
圣兽	cful
噎死	kfgq
枪兵	swrg
苍白无力	awrr
小女生	ihvv
本想	sgsh
整除	gkbw
圣剑	cfwg
盼盼	hwhw
破关	dhud
四字	lhpb
板坯	srfd
系统图	txxy
破军	dhpl
哎呀呀	kaka
四家	lhpg
曹格	gmst
均价	fqww
亚运村	gofc
丁俊晖	sgwc
砌块	dafn
曝气	jjrn
杀怪	rsnc
李平	sbgu
李广	sboy
四岁	lhmq
看盘	rhte
新郑	usud
肠胃炎	enle
新都	usft
李建	sbvg
景程	jytk
喝药	kjax
唐山市	ovmm
雏鹰	qvow
唐钢	ovqm
李强	sbxk
未接	firu
不如人意	dhvk
无计	fqyf
霏霏	fhfh
嘉盛	fkdn
国奥	lgtm
机战	swhk
昕薇	jrat
李志	sbfn
李忠	sbkh
裂化	gqwx
东方神起	aiyy
兄弟们	kqux
唐门	ovuy
圆头	lkud
薰衣草	atye
石岛	dgqy
松嫩	swvg
裕兴	puig
早课	jfyj
石峰	dgmt
领款	wyff
望望	ynyn
无赦	fqfo
刘方敏	yjyy
风投	wrrw
蜜蜡	pnja
仙妮蕾德	wmvn
坝体	fmws
好地方	vbfb
四张	lhxt
孤枕难眠	brsp
商道	yuut
韩红	fjxa
杨幂	snpj
老北京	ftux
日资	jjuq
无路	fqkh
国安	lgpv
硬伤	dgwt
无踪	fqkh
班尼路	gynx
柳丁	sqsg
染剂	ivyj
朦朦	eaea
亲密度	uspn
木木	ssss
圣域	cffa
研修班	dgwh
果奶	jsvb
杨志	snfn
优乐美	wdtn
白象	rrqk
血族	tlyt
加盟商	ekje
李振	sbrd
眯眼	hohv
领涨	wyix
雪龙	fvdx
手工费	rtaa
方钢	yyqm
短息	tdth
旺财	jgmf
无道	fqut
硚口	dtkk
衍文	tiyy
血月	tlee
白跑	rrkh
朴树	shsc
采购部	esmq
团战	lfhk
饭卡	qnhg
雷龙	fldx
柳儿	sqqt
大傻瓜	ddwt
熊明华	ceje
回拨	lkrn
朝歌	fjsk
李敖	sbgq
李敏	sbtx
木槿	sssa
林岳	ssrg
东成西就	aidn
短打	tdrs











人间蒸发	wwuj





















林峰	ssmt













月湖	eeid






捷安特	rgpv
谢霆锋	ytft





























李明	sbje
李春	sbdw
细致入微	xlgc
李晓	sbja
白边	rrep
白送	rrud
林州	ssyt
青阳	gebj
喷血	kftl
阿斯顿	bsad
蝶舞	jarl
街机	tfsw
商院	yubp
眼福	hvpy
李杰	sbso
昂达	jqdp
石排	dgrh
条数	tsov
月灵	eevo
文鼎	yyhn
围挡	lfri
四星	lhjt
为情所困	ytng
大卫杜夫	ddbg
碧云	grfc
装嫩	ufvg
无钱	fqqf
无铅	fqqw
碎冰	dyui
柘城	sdfd
先苦后甜	tfad
饭团	qnlf
暗纹	juxy
国投	lgrw
小妖精	ihvt
血毒	tlgx
杨明	snje
四期	lhad
靓颖	gext
伊能静	wvce
烦躁不安	odkh
直落	fhai
非非	hdhd
李楠	sbsf
四条	lhts
枣强	gmxk
面霸	dmfa
四柱	lhsy
杜桥	sfst
晕血	jptl
香包	tjqn
四核	lhsy
裤头	puud
圣徒	cftf
四格	lhst
在建	dhvg
锐意进取	quuj
表样	gesu
杨村	snsf
林志玲	ssfn
回校	lksy
短板	tdsr
地库	fbol
李正	sbgh
日霜	jjfs
旭阳	vjbj
嗜血	kftl
赛拉图	paru
板料	srou
样例	suwg
李毅	sbue
面馆	dmqn
柱塞	sypa
奥格瑞玛	tmst
李永	sbyn
核保	sywk
无颜	fqut
极昼	sbny
蜀门	lquy
帆布鞋	mhdm
圆整	lkgk
林俊杰	sswc
百阅	djuu
垦利	vetj
蠢猪	dwqt
裸女	puvv
时隙	jfbi
杰森	soss
结构体	xfsq
白陶	rrbq
创可贴	wbsk
四款	lhff
李海	sbit
碳刷	dmnm
狮子王	qtbb
城主	fdyg
火枪手	oosw
西部牛仔	sguk
笔架山	ttek
月的	eerq
裸婚	puvq
飘游	sfiy
补水	puii
核减	syud
机炮	swoq
香坊	tjfy
无骨	fqme
李湘	sbis
天天向上	gdgd
青鸟	geqy
图档	ltsi
眼胶	hvey
韩语	fjyg
饼子	qnbb
短毛	tdtf
爱爱爱	epep
裸官	puph
板楼	srso
砖木	dfss
眼膜	hvea
益达	uwdp
古惑仔	dgak
桥上	sthg
柴家	hxpg
盈通	bcce
圈梁	luiv
夜有所梦	ywde
矮油	tdim
白饭	rrqn
晨读	jdyf
三里屯	dgjf
百试百灵	djyg
兔崽子	qkml
果条	jsts
补漆	puis
系主任	txyg
树妖	scvt
回滚	lkiy
浏阳河	iybj
黄果树	amjs
石浦	dgig
桃叶	sqkf
代表人	wage
减速机	udgk
柳工	sqaa
五庄观	ggof
伊利丹	wvtj
木皮	sshc
木盒	sswg
宠物小精灵	pdtq
皇马	rgcg
石湖	dgid
土桥	ffst
码流	dciy
排兵布阵	rhrg
玻璃板	ghgy
飞狐	nuqt
昭阳	jvbj
婚纱照	vqxi
坏掉	fdrh
李玟	sbgy
复合肥	tjwg
土楼	ffso
韵达	ujdp
补牙	puah
裙摆	purl
做一天和尚撞一天钟	wdgg
基佬	adwf
尸骨无存	nnme
模拟题	sarn
松溪	swie
离心机	yrny
栾城	yofd
桥北	stux
条状	tsud
嘉豪	fkyk
青藏高原	gead
白鹿	rron
黑眼圈	lfhv
瞬移	hetq
直逼	fhgk
协调发展	feym
蜀黍	lqtw
小太阳	ihdy
案场	pvfn
相送	shud
桥口	stkk
春香	dwtj
磨叽	oskw
直邮	fhmb
星驰	jtcg
矿点	dohk
英语系	amyg
砖混	dfij
白龙	rrdx
月线	eexf
杀码	rsdc
城固	fdld
炸弹人	otxu
磷化	dowx
五险一金	ggbw
梁军	ivpl
本章	sguj
血祭	tlwf
晋阳	gobj
裸捐	purk
四瓶	lhua
西单	sgul
西华	sgwx
月考	eeft
坑杀	fyrs
军需官	plfd
昌黎	jjtq
瞎聊	hpbq
培华	fuwx
枫泾	swic
斯诺克	adya
辞职信	tdbk
破法	dhif
松狮	swqt
装死	ufgq
补眠	puhn
黑白照	lfrr
韶钢	ujqm
圣湖	cfid
码率	dcyx
框子	sabb
四眼	lhhv
裙楼	puso
月舞	eerl
饰板	qnsr
梁咏琪	ivky
韩雪	fjfv
暖通	jece
存储卡	dhwy
伤心事	wtny
木纹	ssxy
补碘	pudm
祁东	pyai
国瑞	lggm
交通卡	ywce
裸替	pufw
堂哥	ipsk
暴走	jafh
西固	sgld
栾川	yokt
蝶阀	jauw
杂类	vsod
眼贴	hvmh
交通厅	ywce
板甲	srlh
考勤机	ftak
伏牛山	wdtg
本群	sgvt
不要这样	dhsv
柳林	sqss
枪火	swoo
入土为安	tyff
地级市	fbxb
如果爱	vkjs
杨磊	sndd
桂平	sfgu
梁园	ivlf
代表处	wage
西塘	sgfo
标日	sfjj
正式工	ghga
柴桑	hxcc
矸石	dfdg
晴雯	jgfy
晴雨	jgfg
衰神	ykpy
地火	fboo
彼此之间	thhx
省院	itbp
电视卡	jnpy
西大	sgdd
圣物	cftq
西奈	sgdf
果珍	jsgw
绝不后悔	xqdh
餐盒	hqwg
枪版	swth
餐盘	hqte
塑业	ubog
桃心	sqny
系统盘	txxy
桩子	sobb
裸模	pusa
四篇	lhty
堂堂	ipip
四分之一	lhwv
磨山	osmm
塘下	fogh
香木	tjss
塑件	ubwt
狗不理	qtdh
李红	sbxa
棠下	ipgh
风花雪夜	wraw
型材	gasf
张志东	xtfn
新媒体	usva
李维	sbxw
真钱	fhqf
砌砖	dadf
马云	cgfc
血精灵	tlog
碎梦	dyss
信誉度	wyig
卡丁车	hgsg
万人迷	gqww
堂妹	ipvf
报名表	rbqk
马会	cgwf
地王	fbgg
月光曲	eeig
金河田	qqis
碟机	dasw
朱莉	riat
飞羽	nunn
神偷	pyww
石粉	dgow
闯关东	ucud
图稿	ltty
风雨同路	wrfg
马修	cgwh
月光族	eeig
黑衣人	lfye
坏点	fdhk
快乐大本营	nntn
真难	fhcw
破甲	dhlh
截然相反	fwqd
晚黑	jqlf
盘龙	tedx
神兽	pyul
领证	wyyg
碧柔	grcn
河西区	issg
救援队	gire
矿粉	doow
短绒	tdxa
城投	fdrw
马六	cgyw
噗通	koce
晨鸣	jdkq
神剑	pywg
四联	lhbu
优酷网	wdsg
破皮	dhhc
坑爹	fywr
杏色	skqc
马凯	cgmn
挡土墙	riff
圆管	lktp
无可替代	fqsk
小笨蛋	ihts
杉菜	seae
有课	deyj
领跑	wykh
香河	tjis
普陀区	uobp
袁绍	fkxv
香洲	tjiy
标清	sfig
基德	adtf
装着	ufug
填制	ffrm
树洞	scim
大环境	ddgd
驾到	ekgc
以德服人	nytf
眼霜	hvfs
票号	sfkg
树海	scit
神啊	pykb
梨子	tjbb
大钟寺	ddqk
驴友	cgdc
客服部	pteb
椎体	swws
瞎跑	hpkh
马哲	cgrr
安娜苏	pvvn
潜行者	iftg
国美	lgug
曾远	ulfq
神器	pykk
网大为	mrdd
飞虎	nuha
颐达	ahdp
飞虹	nuja
伸张正义	wjxt
何以见得	wsny
贸易通	qyjq
稀里哗啦	trjf
英语课	amyg
回蓝	lkaj
土系	fftx
哈根达斯	kwsv
垫江	rvia
孙燕姿	biak
塑壳	ubfp
神墓	pyaj
地籍	fbtd
暗黑	julf
顺鑫	kdqq
裸男	pule
青城山	gefd
姐弟恋	veux
地精	fbog
西数	sgov
硬皮	dghc
刘嘉玲	yjfk
驻场	cgfn
朗逸	yvqk
促膝长谈	wkes
义勇军进行曲	yrce
天差地别	gdug
沈殿霞	ipna
碘片	dmth
佟大为	wtdd
风讯	wryn
石虎	dgha
衣裙	yepu
严纪年	goxn
培新	fuus
回血	lktl
裸睡	puht
圣职	cfbk
桃浦	sqig
坏笑	fdtt
实验楼	pucg
地缝	fbxt
资料片	uqou
地网	fbmr
短袖	tdpu
森女	ssvv
塔山	famm
鬼剑士	rqwg
邯郸市	aful
行距	tgkh
型男	gale
行路	tgkh
高仿	ykwy
触屏	qenu
梅村	stsf
暴龙	jadx
西楼	sgso
桥段	stwd
骊威	cgdg
林志颖	ssfn
马币	cgtm
顺驰	kdcg
餐补	hqpu
硅脂	dfex
马庄	cgof
碎碎	dydy
飚车	wrlg
街车	tflg
枯燥乏味	sdok
培正	fugh
领驭	wycg
谭咏麟	ysky
西沙	sgii
回踩	lkkh
磁环	dugd
电视柜	jnpy
西河	sgis
坎肩	fqyn
被虐	puha
骊山	cgmm
秘制	tnrm
福字	pypb
临沂市	jtir
延长线	thta
固话	ldyt
莫文蔚	ajyy
福山	pymm
塔拉	faru
垫着	rvug
壹仟	fpwt
星辰变	jtdf
下酒菜	ghis
禹城	tkfd
杨过	snfp
榆中	swkh
观月	cmee
回邮	lkmb
圣衣	cfye
区医院	arat
裸考	puft
裸聊	pubq
汽车票	irlg
国足	lgkh
毫无怨言	ykfq
树精	scog
本项	sgad
地下城	fbgh
高四	yklh
欺师灭祖	adjg
李铁	sbqr
棉服	sreb
皮尔洛	hcqi
核磁	sydu
实验班	pucg
但说无妨	wjyu
地裂	fbgq
效果图	ywjs
生孩子	tgby
福彩	pyes
秀女	tbvv
打底裤	rsoq
咨询师	uqyq
角标	qesf
被试	puyg
李阳	sbbj
国通	lgce
补钙	puqg
马斯	cgad
高级群	ykxb
极道	sbut
解暑	qejf
心无杂念	nyfq
张信哲	xtwy
梓潼	suiu
核突	sypw
黑曜石	lfjn
李雪	sbfv
桦甸	swql
巴蒂尔	cnay
李靖	sbug
大三	dddg
李青	sbge
街霸	tffa
高妹	ykvf
楼号	sokg
西王	sggg
西环	sggd
神枪	pysw
行风	tgwr
太严	dygo
大二	ddfg
飒飒	uwuw
图释	ltto
大件	ddwt
磨皮	oshc
大伟	ddwf
骏捷	cgrg
四院	lhbp
血魔	tlos
塘桥	fost
禁摩	ssos
税单	tuul
补集	puwy
大佬	ddwf
秋实	topu
马格	cgst
韩国人	fjlg
禁播	ssrt
禹州	tkyt
黑白配	lfrr
央企	mdwh
七里香	agjf
白费力气	rrxj
全家桶	wgpg
两个人	gmwh
香芋	tjag
裤衩	pupu
科密	tupn
驻村	cgsf
复变	tjyo
裤裆	pupu
考勤表	ftak
城站	fduh
巴菲特	cnah
被逼	pugk
外区	qhar
外协	qhfe
大元	ddfq
天关	gdud
矿长	dota
固镇	ldqf
图铃	ltqw
妄自菲薄	ynth
加盟费	ekje
侠盗飞车	wguq
周六日	mfyw
观澜	cmiu
高州	ykyt
魔仙	oswm
砸车	dalg
大副	ddgk
奉子成婚	dwbb
松阳	swbj
裸衣	puye
校色	syqc
福晋	pygo
圈钱	luqf
天劫	gdfc
够吗	qkkc
布兰妮	dmud
硬解	dgqe
四驱	lhcg
失分	rwwv
大单	ddul
大华	ddwx
止步不前	hhhh
校草	syaj
世界之窗	anlw
大厨	dddg
回骂	lkkk
松露	swfk
大叶	ddkf
楚州	ssyt
石首	dgut
奚丹	exmy
图面	ltdm
复垦	tjve
鬼叫	rqkn
颗粒无收	jsou
碧落	grai
知恩图报	tdld
魔兽	osul
飞鸽	nuwg
右下角	dkgh
西站	sguh
质检部	rfsw
飞鹤	nupw
夜黑风高	ywlf
魔剑	oswg
大嘴	ddkh
魏县	tveg
圆领	lkwy
奥体	tmws
夺命	dfwg
囚鸟	lwqy
简答题	tutw
大圆	ddlk
大圈	ddlu
梁静茹	ivge
奉化	dwwx
坏道	fdut
枣阳	gmbj
天圣	gdcf
瞄准镜	hauw
大冒险	ddjh
大坪	ddfg
夜壶	ywfp
魔君	osvt
春秋大梦	dwto
外委	qhtv
奈叶	dfkf
夜奔	ywdf
大堆	ddfw
基类	adod
够多	qkqq
天域	gdfa
税局	tunn
大塘	ddfo
退换货	verq
渝中区	iwkh
多姿	qquq
女体	vvws
破防	dhby
女侠	vvwg
驻澳	cgit
自寻死路	thvf
桔色	sfqc
大壮	dduf
砸门	dauy
头型	udga
套卡	ddhg
精装修	oguf
祖玛	pygc
硅铁	dfqr
榛子	sdbb
外审	qhpj
外宣	qhpg
高敏	yktx
高攻	ykat
马牌	cgth
椒江	shia
高数	ykov
驻点	cghk
大姚	ddvq
秋明	toje
太妹	dyvf
二手房	fgrt
兄弟连	kqux
小家电	ihpg
外展	qhna
狂蜂浪蝶	qtjt
大婚	ddvq
裸退	puve
天娱	gdvk
高昌	ykjj
破音	dhuj
其利断金	adtj
太婆	dyih
女刊	vvfj
魔域	osfa
被骂	pukk
塞班	pagy
大宋	ddps
纳米盘	xmoy
马琳	cggs
天宏	gdpd
天宝	gdpg
秒杀	tirs
圣骑	cfcg
年少轻狂	rhit
科林	tuss
租赁费	tewt
奔四	dflh
大屯	ddgb
马甸	cgql
圣魔	cfos
空口	pwkk
覆膜	stea
千依百顺	tfwy
绿化带	xvwx
夜店	ywoh
饭钱	qnqf
离歌	yrsk
奉天	dwgd
西芹	sgar
学习部	ipnu
西苑	sgaq
解盘	qete
头尾	udnt
大市	ddym
康宝莱	ovpg
天师	gdjg
好姑娘	vbvd
培英	fuam
奔头	dfud
张惠妹	xtgj
魔宫	ospk
奥城	tmfd
以大欺小	nydd
税控	turp
奶嘴	vbkh
大德	ddtf
大志	ddfn
触碰	qedu
天心	gdny
梭织	scxk
饰面	qndm
梅菜	stae
夺帅	dfjm
解离	qeyr
天恒	gdng
土龙	ffdx
昼伏夜出	nywd
易建联	jqvg
魅影	rqjy
魔岩三杰	osmd
言出必行	yybm
巴厘岛	cndj
驱程	cgtk
稍晚	tijq
地鼠	fben
高淳	ykiy
魅惑	rqak
指导书	rxnf
女女	vvvv
秦殇	dwgq
榆木	swss
综合办	xpwg
大招	ddrv
西街	sgtf
妹儿	vfqt
奇强	dsxk
横县	saeg
社联	pybu
姐们	vewu
奥山	tmmm
李孝利	sbft
手足口病	rtkh
西西	sgsg
夏末	dhgs
趾高气昂	khyk
妮可	vnsk
填筑	ffta
激活码	irit
一剪梅	ggue
导游证	nfiy
女尊	vvus
国际版	lgbf
天敏	gdtx
魔战	oshk
解绑	qexd
桑达	ccdp
配置单	sglf
塔罗	falq
次氯酸钠	uqrn
梅西	stsg
碗面	dpdm
积液	tkiy
国防生	lgby
置顶帖	lfsd
栖霞	ssfn
塞纳	paxm
大智	ddtd
窝头	pwud
碳钢	dmqm
多核	qqsy
换位思考	rqwu
洗洁精	itif
余秋雨	wgto
车架号	lgek
天月	gdee
第四个	txlh
妖姬	vtva
魅族	rqyt
空床	pwos
香蕉皮	tjaw
碎骨	dyme
天柱	gdsy
太阳井	dybj
窄带	pwgk
西路	sgkh
阿森纳	bsss
魔教	osft
魔族	osyt
魏晨	tvjd
老友记	ftdc
魔星	osjt
好彩	vbes
夏河	dhis
魔晶	osjj
丹尼斯	mynx
奎文	dfyy
好快	vbnn
笔仙	ttwm
天正	gdgh
墨竹	lfth
墨笔	lftt
妮子	vnbb
站场	uhfn
榨汁	spif
中山路	khmm
魔棒	ossd
讨人	yfww
小宝贝	ihpg
城阳	fdbj
威刚	dgmr
城际	fdbf
娇兰	vtud
套机	ddsw
窝心	pwny
珍珠粉	gwgr
大洼	ddif
天泽	gdic
楼猪	soqt
鬼泣	rqiu
棉裤	srpu
威化	dgwx
秋种	totk
讲价	yfww
横店	saoh
奥普	tmuo
委外	tvqh
金山毒霸	qqmm
姜堰	ugfa
大港	ddia
高科	yktu
深发展	ipnt
壮男	ufle
太清	dyig
橡塑	squb
许仙	ytwm
夜火	ywoo
娟儿	vkqt
奶昔	vbaj
格鲁	stqg
增肥	fuec
多爽	qqdr
桂鱼	sfqg
离网	yrmr
等会	tfwf
大电影	ddjn
大熊	ddce
情侣号	ngwk
姨婆	vgih
复用	tjeh
卡片机	hgth
策划书	tgaj
论剑	ywwg
如月	vkee
筒体	tmws
诛仙	yrwm
天牢	gdpt
电话号	jnyt
梅陇	stbd
胡宗宪	depf
鬼片	rqth
禁行	sstg
高线	ykxf
马诺	cgya
小毛驴	ihtf
海拉尔	itru
财富卡	mfpg
大班	ddgy
魔灵	osvo
骑行	cgtg
鬼王	rqgg
秦鹏程	dwee
女款	vvff
评卷	ygud
暴风影音	jawr
证号	ygkg
周华健	mfwx
马超	cgfh
禁言	ssyy
西马	sgcg
读万卷书	yfgq
康师傅	ovjg
第四届	txlh
天界	gdlw
项目组	adhh
鲁东	qgai
楼管	sotp
威客	dgpt
居无定所	ndfq
神达	pydp
横杆	sasf
反病毒	rcug
横条	sats
试吃	ygkt
笋岗	tvmm
天目	gdhh
话单	ytul
奇珍	dsgw
保定市	wkpg
二十几	fgfg
大码	dddc
声线	fnxf
葫芦娃	aday
数据源	ovrn
校内网	symw
套牌	ddth
玛莎拉蒂	gcai
塔里	fajf
性冷淡	ntuw
误判	ykug
避风塘	nkwr
大雁塔	dddw
魏公村	tvwc
高速路	ykgk
大神	ddpy
祁阳	pybj
外管	qhtp
大福	ddpy
天福	gdpy
魔盒	oswg
虹口区	jakk
毛利率	tftj
讲完	yfpf
验车	cglg
天穹	gdpw
魔眼	oshv
皮糙肉厚	hcot
李宇春	sbpg
香榭丽舍	tjst
彻彻底底	tata
奥组委	tmxe
难以启齿	cwny
多糖	qqoo
魔石	osdg
姜文	ugyy
太笨	dyts
骐达	cgdp
女版	vvth
竖条	jcts
大箱	ddts
奇石	dsdg
奶爸	vbwr
奶片	vbth
马钢	cgqm
恶魔岛	goos
横河	sais
鲍勃	qgfp
秋衣	toye
窑炉	pwoy
解闷	qeun
橙果	swjs
魔神	ospy
许嵩	ytmy
阿童木	bsuj
旭日升	vjjj
神雕	pymf
签售	twwy
筒子	tmbb
产业链	utog
非比寻常	hdxx
次元	uqfq
马面	cgdm
读图	yflt
惟我独尊	nwtr
契税	dhtu
逝者已矣	rrft
大蛇丸	ddjp
欧典	arma
天罗	gdlq
简图	tult
大老	ddft
大考	ddft
讨打	yfrs
梦龙	ssdx
天翔	gdug
感激不尽	dgir
天翼	gdnl
运算符	fcth
有限元	debv
天联	gdbu
谥号	yukg
毫无用处	ykfq
语嫣	ygvg
好白	vbrr
大胸	ddeq
歇会	jqwf
调增	ymfu
大脸	ddew
妙玉	vigy
娃娃脸	vfvf
神鬼	pyrq
神魔	pyos
私车	tclg
白名单	rrqk
高跟	ykkh
小游戏	ihiy
关注度	udiy
秀逗	tbgk
箱号	tskg
妖界	vtlw
大英	ddam
中转站	khlf
驱鬼	cgrq
驱魔	cgos
奇美	dsug
森马	sscg
长江大桥	taia
深蓝色	ipaj
空空	pwpw
标题党	sfjg
小沈阳	ihip
科达	tudp
宝安区	pgpv
弱水三千	xuii
榴莲	sqal
正佳	ghwf
大蓝	ddaj
确认单	dqyw
天蓬	gdat
认栽	ywfs
宝贝儿	pgmh
七分裤	agwv
评教	ygft
大虎	ddha
神龟	pyqj
谢娜	ytvn
竖版	jcth
箭塔	tufa
正元	ghfq
天虹	gdja
小纸条	ihxq
算子	thbb
马龙	cgdx
雨林木风	fgss
卤制品	hlrm
婚戒	vqaa
私钥	tcqe
婚房	vqyn
槐荫	srab
示范户	fiai
窝窝	pwpw
韩国语	fjlg
高钙	ykqg
下拉框	ghru
竹炭	thmd
华南虎	wxfm
高铁	ykqr
谍影	yajy
立白	uurr
残体	gqws
止呕	hhka
容祖儿	pwpy
欧宝	arpg
弹弹堂	xuxu
称量	tqjg
人流量	wwiy
欧尚	arim
秘银	tnqv
残值	gqwf
付立群	wfuu
高阳	ykbj
魔蝎	osjj
歹势	gqrv
科院	tubp
骸骨	meme
管庄	tpof
血肉模糊	tlmw
使馆区	wgqn
老顾客	ftdb
魔血	ostl
项目部	adhh
笑点	tthk
豪园	yklf
款子	ffbb
天语	gdyg
管径	tptc
歌姬	skva
嫂嫂	veve
武圣	fhcf
储蓄罐	wyay
排气管	rhrn
高领	ykwy
闸北区	ulux
大货	ddwx
小鸡鸡	ihcq
陈楚生	bass
秋香	totj
好茶	vbaw
等死	tfgq
外送	qhud
端盖	umug
天路	gdkh
正处	ghth
模考	saft
亲耐滴	usdm
正太	ghdy
段位	wdwu
强迫症	xkrp
试水	ygii
移门	tquy
楼长	sota
天达	gddp
死城	gqfd
天逸	gdqk
迪士尼	mpfg
大邑	ddkc
摆地摊	rlfb
记牌	ynth
欧拉	arru
欠揍	qwrd
武宁	fhps
橡筋	sqte
空行	pwtg
大酱	dduq
杨门女将	snuy
自取其辱	thbc
沙巴克	iicn
鬼吹灯	rqkq
比伯	xxwr
端端	umum
雷霆崖	flft
孔位	bnwu
孝义	ftyr
外链	qhql
笨瓜	tsrc
紫水晶	hxii
外键	qhqv
休闲服	wsus
筒灯	tmos
豪庭	ykot
外门	qhuy
稍安勿躁	tipv
人事厅	wwgk
太阳石	dybj
武广	fhoy
电子厂	jnbb
比克	xxdq
外院	qhbp
词牌	ynth
欧普	aruo
米亚	oygo
奥赛	tmpa
心静如水	nyge
太钢	dyqm
礼拜二	pyrd
马到功成	cggc
礼拜一	pyrd
礼拜三	pyrd
立花	uuaw
沐浴露	isiw
永无止尽	ynfq
记着	ynug
阿奎那	bsdf
哈士奇	kwfg
粉底液	owoq
子午	bbtf
女贼	vvma
天阵	gdbl
奥达曼	tmdp
大雄	dddc
天雷	gdfl
箱梁	tsiv
宁乡	psxt
复验	tjcg
同仁堂	mgwf
婺源	cnid
安丘	pvrg
电子城	jnbb
供电局	wajn
哥斯拉	skad
粉体	owws
安乡	pvxt
健身卡	wvtm
名人堂	qkww
夷陵	gxbf
安亭	pvyk
季卡	tbhg
大题	ddjg
营业执照	apog
天顺	gdkd
笨笨	tsts
管沟	tpiq
贡丸	amvy
标题栏	sfjg
气人	rnww
犹豫不定	qtcn
残影	gqjy
安信	pvwy
奇门	dsuy
讲笑	yftt
天香	gdtj
天圆地方	gdlk
洛丽塔	itgm
惠州市	gjyt
头颈	udca
试着	ygug
宝丰	pgdh
蚁力神	jyen
内存卡	mwdh
子城	bbfd
货代	wxwa
老人与海	ftww
正方	ghyy
诺玛	yagc
欧派	arir
类名	odqk
天鬼	gdrq
天魔	gdos
个人版	whww
白虎堂	rrha
安凯	pvmn
当家做主	ivpg
宁化	pswx
宏兴	pdig
货值	wxwf
定值	pgwf
双面胶	ccdm
三局两胜	dgnn
失魂	rwfc
花木兰	awss
礼拜四	pyrd
站街	uhtf
魅魔	rqos
负分	qmwv
安卓	pvhj
痛彻心扉	ucta
太阳花	dybj
永丰	yndh
什么人	wftc
毓婷	txvy
什么事	wftc
宝光	pgig
宝兴	pgig
魍魉	rqrq
安吉	pvfk
心诚则灵	nyyd
孕婴	bbmm
供电所	wajn
大鸟	ddqy
类图	odlt
精仿	ogwy
脑白金	eyrr
天鸿	gdia
大黄	ddam
大黑	ddlf
勾三搭四	qcdg
永修	ynwh
大鼓	ddfk
孟婆	blih
孔家	bnpg
精修	ogwh
数据集	ovrn
资信	uqwy
学姐	ipve
太鼓	dyfk
学委	iptv
米奇	oyds
大龙	dddx
米妮	oyvn
货号	wxkg
童言	ujyy
万利达	gqtj
米娜	oyvn
欧版	arth
好闷	vbun
读碟	yfda
宝山区	pgmm
精元	ogfq
大明星	ddje
正步	ghhh
财商	mfyu
度假村	oawn
佛跳墙	wxkh
学学	ipip
木秀于林	sstb
宋国	pslg
密保	pnwk
红色警戒	xaqc
心无旁骛	nyfq
歪歪	dhdh
委托人	tvrt
恭候大驾	awwh
试练	ygxa
宋城	psfd
费县	xjeg
白蛇传	rrjp
合得来	wgtj
鱼竿	qgtf
次生	uqtg
水口	iikk
玉泉路	gyri
宏基	pdad
汉典	icma
孟州	blyt
宝器	pgkk
张艺谋	xtan
宅女	ptvv
粽叶	opkf
寡人	pdww
宝图	pglt
金三顺	qqdg
容县	pweg
水哥	iisk
审图	pjlt
赵云	fhfc
气头	rnud
管着	tpug
宜城	pefd
走位	fhwu
小老婆	ihft
笔袋	ttwa
总冠军	ukpf
起亚	fhgo
密匙	pnjg
汉南	icfm
宁安	pspv
欠着	qwug
女魔	vvos
孙悦	binu
天生丽质	gdtg
塔罗牌	falq
学弟	ipux
情侣装	ngwk
贵国	khlg
孤影	brjy
汴京	iyyk
鸳鸯浴	qbmd
一整天	gggk
竞速	ukgk
是非之地	jghd
米其林	oyad
箍筋	trte
瑟吉欧	ggfk
孝感	ftdg
类库	odol
奥鹏	tmee
水坑	iify
恒源祥	ngid
寄售	pdwy
贞子	hmbb
热水澡	rvii
贝宝	mhpg
寻仙	vfwm
安岳	pvrg
赣南	ujfm
仗义疏财	wdyr
合作方	wgwt
江华	iawx
白雪公主	rrfv
背背山	uxux
豪爵	ykel
汽修	irwh
对倒	cfwg
贱婢	mfvr
欧科	artu
宜家	pepg
鱼肠	qgen
宽城	pafd
苏打绿	aers
水妖	iivt
婷美	vyug
小乔	ihtd
老顽童	ftfq
死灵	gqvo
宜山	pemm
鸟事	qygk
封停	ffwy
心烦气躁	nyod
系别	txke
小仙	ihwm
宣导	pgnf
米拉	oyru
大智慧	ddtd
起卦	fhff
小众	ihww
鸣人	kqww
昏昏沉沉	qaqa
小伤	ihwt
过路费	fpkh
人工费	wwaa
粒径	outc
汤唯	inkw
天下无敌	gdgh
武则天	fhmj
素人	gxww
贵局	khnn
宜州	peyt
子机	bbsw
官庄	phof
认账	ywmt
玉渊潭	gyit
赤坎	fofq
小事情	ihgk
孔板	bnsr
导医	nfat
资审	uqpj
比格	xxst
学文	ipyy
系咪	txko
水岸	iimd
会员价	wfkm
沂南	irfm
立顿	uugb
非奸即盗	hdvf
规划局	fwaj
歌神	skpy
导员	nfkm
头文件	udyy
小刘	ihyj
小利	ihtj
贵店	khoh
贵庚	khov
沙冰	iiui
发短信	nttd
永州	ynyt
小勺	ihqy
汉寿	icdt
安捷	pvrg
小华	ihwx
沙加	iiek
孙楠	bisf
小卫	ihbg
小卡	ihhg
小弟弟	ihux
怪叔叔	nchg
密山	pnmm
沙包	iiqn
前男友	uele
康熙来了	ovah
凯美瑞	mnug
选项卡	tfad
赛尔	paqi
粉料	owou
会员名	wfkm
小老板	ihft
导图	nflt
死皮	gqhc
第四集	txlh
武神	fhpy
汉川	ickt
宁晋	psgo
粉晶	owjj
江安	iapv
酒仙桥	iswm
毛毛	tftf
跑位	khwu
赤岗	fomm
武穴	fhpw
赖床	gkos
小嘴	ihkh
安普	pvuo
治具	ichw
沧口	iwkk
封基	ffad
宏昌	pdjj
展业	naog
威海市	dgit
汤山	inmm
小四	ihlh
小图	ihlt
郭富城	ykpg
等车	tflg
孙涛	biid
误认	ykyw
宏村	pdsf
孟津	bliv
油卡	imhg
菜单栏	aeul
起搏器	fhrg
沙坪	iifg
波斯猫	ihad
波仔	ihwb
请讲	ygyf
公交卡	wcyw
说课	yuyj
奇思妙想	dsln
货期	wxad
学海	ipit
法克	ifdq
小套	ihdd
策划部	tgaj
注会	iywf
物业费	tqog
实木	puss
小如	ihvk
小妞	ihvn
尾号	ntkg
鹿丸	onvy
霍华德	fwwx
走形	fhga
山丹	mmmy
张卫健	xtbg
汶川	iykt
建设银行	vgyw
鸡婆	cqih
调调	ymym
威驰	dgcg
鸭头	lqud
贴条	mhts
泵体	diws
郑伊健	udwv
不离不弃	dhyr
群雄争霸	vtdc
休闲裤	wsus
贴标	mhsf
贵宾卡	khpr
跟单	khul
孜然	btqd
鸡子	cqbb
紫夜	hxyw
豹纹	eqxy
跑商	khyu
正股	ghew
调货	ymwx
鹰击	owgb
水杯	iisd
宁津	psiv
字牌	pbth
神州行	pyyt
沙宣	iipg
吴宵光	kgpi
正脸	ghew
箭袋	tuwa
腾讯网	euyn
汉斯	icad
跑跑卡丁车	khkh
超快	fhnn
纯属虚构	xgnt
索尔	fpqi
宏泰	pddw
宾果	prjs
鸟市	qyym
富春	pgdw
答铃	twqw
汉服	iceb
许飞	ytnu
病毒库	uggx
安溪	pvie
超慢	fhnj
调速	ymgk
沙巴	iicn
尼奥	nxtm
钻木取火	qhss
宏源	pdid
气源	rnid
跟团	khlf
宣汉	pgic
电子稿	jnbb
对戒	cfaa
暗物质	jutq
乖宝宝	tfpg
赫敏	fotx
张弛有度	xtxb
寒月	paee
泰和	dwtk
泊头	irud
氮气	rnrn
嫁衣	vpye
贵池	khib
天行健	gdtg
小怪	ihnc
紫川	hxkt
泛型	itga
赤月	foee
精武	ogfh
踏勘	khad
世博会	anfg
赴日	fhjj
宠溺	pdix
赶早	fhjf
赫本	fosg
该隐	yybq
麦兜	gtrq
陈奕迅	bayo
岩体	mdws
江桥	iast
两小无猜	gmih
民爆	naoj
永济	yniy
汉武	icfh
黄书	amnn
筹钱	tdqf
米白	oyrr
泰坦	dwfj
赣榆	ujsw
永清	ynig
豆豆	gkgk
三险一金	dgbw
流氓兔	iyyn
横刀立马	savn
对时	cfjf
孙祥	bipy
鹿城	onfd
正街	ghtf
麦博	gtfg
孽畜	awyx
流亭	iyyk
容积率	pwtk
范跑跑	aikh
泪奔	ihdf
欧迪	armp
验证码	cgyg
汗死	ifgq
花花草草	awaw
黑仔	lfwb
大石头	dddg
宅男	ptle
对杀	cfrs
调阅	ymuu
安瓶	pvua
完璧	pfnk
鹤山	pwmm
龙凤胎	dxwc
简阳	tubj
孙策	bitg
子类	bbod
汇源	iaid
对标	cfsf
吴宗宪	kgpf
汉源	icid
老本行	ftsg
沪指	iyrx
水煮	iift
尿急	niqv
容灾	pwpo
命犯桃花	wgqt
商贸城	yuqy
法库	ifol
安监	pvjt
火凤燎原	oowc
绿树成荫	xvsc
佐丹奴	wdmy
吉他谱	fkwb
麻吉	osfk
名侦探	qkwh
纪念版	xnwy
宇瞻	pghq
宏盛	pddn
超模	fhsa
化学键	wxip
跨年	khrh
降妖除魔	btvt
水玉	iigy
贼王	magg
江湾	iaiy
洋妞	iuvn
贱男	mfle
奥巴马	tmcn
气短	rntd
紫星	hxjt
江滨	iaip
跳帧	khmh
龟苓膏	qjaw
浪人	iyww
紫晶	hxjj
宝盒	pgwg
实盘	pute
调高	ymyk
袖里乾坤	pujf
大蜘蛛	ddjt
中心线	khny
休闲鞋	wsus
泳帽	iymh
赌王	mfgg
泰康	dwov
鱼鳔	qgqg
日本车	jjsg
火箭队	ootu
小樱	ihsm
简体字	tuws
麻城	osfd
毒舌	gxtd
海伦	itww
洋山	iumm
浙北	irux
竭尽所能	ujny
宽甸	paql
正途	ghwg
王老吉	ggft
岔子	wvbb
封测	ffim
花样年华	awsu
鲍鱼	qgqg
浚县	iceg
射洪	tmia
寒玉	pagy
闺中密友	ufkh
孙良	biyv
弗朗西斯	xjyv
沂源	irid
踏平	khgu
倚天屠龙记	wdgd
貔貅	etew
防辐射	bylg
麻姑	osvd
氯碱	rndd
黑土	lfff
货站	wxuh
油桃	imsq
财管	mftp
停车费	wylg
麻婆	osih
浙商	iryu
卡哇伊	hgkf
浦发	ignt
浦口	igkk
小海	ihit
趁热	fhrv
尼桑	nxcc
水神	iipy
水票	iisf
宝箱	pgts
消停	iiwy
不明就里	dhje
对焊	cfoj
紫气	hxrn
躁动	khfc
大染坊	ddiv
东北人	aiux
身下	tmgh
射灯	tmos
静安寺	gepv
新乡市	usxt
沪江	iyia
黑妞	lfvn
沙湾	iiiy
黑妹	lfvf
路政	khgh
鲫鱼	qgqg
水站	iiuh
法杖	ifsd
沙溪	iiie
外高桥	qhyk
超爽	fhdr
黄宇	ampg
山推	mmrw
黄家	ampg
内测号	mwim
棋牌室	sath
赌神	mfpy
贝罗	mhlq
求租	gite
崔健	mwwv
安联	pvbu
岱山	wamm
天真无邪	gdfh
黄岛	amqy
陆小凤	bgih
鸡翅膀	cqfc
嘻游记	kfiy
官网	phmr
学生们	iptg
安腾	pveu
浦城	igfd
噬魂师	ktfc
涉县	iheg
七星彩	agjt
贤者	jcft
尾气	ntrn
白月光	rree
液位	iywu
武隆	fhbt
资粮	uqoy
毛衫	tfpu
小爱	ihep
小牛	ihtg
泡椒	iqsh
课代表	yjwa
赶着	fhug
黄建	amvg
尖牙	idah
核销单	syqi
紫烟	hxol
识骨寻踪	ykme
粉蓝	owaj
黄忠	amkh
家纺	pgxy
小球	ihgg
黑店	lfoh
走神	fhpy
泽林	icss
铁齿铜牙	qrhw
仙踪林	wmkh
垃圾袋	fufb
娇艳欲滴	vtdh
小瓶	ihua
职业装	bkog
润发	iunt
海妖	itvt
贴膜	mhea
贝蒂	mhay
对砍	cfdq
波比	ihxx
斗破苍穹	ufdh
峡山	mgmm
小老虎	ihft
施工员	ytaa
汉网	icmr
胡辣汤	deud
注水	iyii
波波	ihih
消声	iifn
武魂	fhfc
冤大头	pqdd
鸡皮	cqhc
浮山	iemm
切尔西	avqi
密聊	pnbq
注浆	iyuq
工程局	aatk
紫电	hxjn
提拉米苏	rjru
尾牙	ntah
德莱尼	tfag
小码	ihdc
篮球场	tjgg
浓情	ipng
尿片	nith
街道口	tfut
费蓝	xjaj
周星星	mfjt
子道	bbut
娘娘腔	vyvy
浴帘	iwpw
从头再来	wwud
大饭店	ddqn
涉密	ihpn
赏花	ipaw
淘券	iqud
小秘	ihtn
猪头肉	qtud
封箱	ffts
跑环	khgd
占用率	hkeh
累着	lxug
屯溪	gbie
富甲天下	pglh
毛邓	tfcb
卡卡西	hghg
海康	itov
汉莎	icai
豪华版	ykwx
触景伤情	qejy
黄村	amsf
踏浪	khiy
沙湾镇	iiiy
鼻头	thud
岩棉	mdsr
女人们	vvww
小箱	ihts
洪楼	iaso
洋浦	iuig
崇州	mpyt
施工图	ytaa
脑筋急转弯	eyte
石头记	dgud
洗水	itii
没空	iwpw
断背山	onux
混元	ijfq
气话	rnyt
小类	ihod
消弱	iixu
肚皮舞	efhc
安贞	pvhm
混凝	ijux
泻火	ipoo
学生妹	iptg
池莉	ibat
鼠年	enrh
洗液	itiy
黑桃	lfsq
安踏	pvkh
红丝	xaxx
油票	imsf
赵芳	fhay
清光	igig
日思夜想	jjln
超能	fhce
质谱	rfyu
点击量	hkgb
岑溪	mwie
北师大	uxjg
海拉	itru
红伞	xawu
洋火	iuoo
山王	mmgg
尊老	usft
店大欺客	ohdd
贷记	wayn
浸提	ivrj
宜山路	pemm
纠偏	xnwy
路痴	khut
岳池	rgib
黄江	amia
法硕	ifdd
测试版	imyg
清原	igdr
纳什	xmwf
清台	igck
王心凌	ggny
鸡肝	cqef
赵薇	fhat
气道	rnut
鹰眼	owhv
小脑	ihey
路盲	khyn
活法	itif
龙卡	dxhg
起薪	fhau
鸡脚	cqef
口不择言	kkdh
子项	bbad
法神	ifpy
勾肩搭背	qcyn
赤血	fotl
飞轮海	nulw
海昌	itjj
流油	iyim
踩点	khhk
洗牙	itah
粉煤灰	owoa
成就感	dnyk
组人	xeww
召唤兽	vkkq
小花	ihaw
浇注	iaiy
渝北	iwux
浅浅	ifif
淘客	iqpt
练习册	xanu
鸭腿	lqev
丫头片子	uhud
粉钻	owqh
紧致	jcgc
红名	xaqk
海格	itst
嵊州	mtyt
讨论组	yfyw
安钢	pvqm
糖豆	oogk
工程款	aatk
浓浓	ipip
海椒	itsh
宝鉴	pgjt
菲拉斯	ahru
湖东	idai
温县	ijeg
宁阳	psbj
鹅肝	tref
济源	iyid
朱元璋	rifq
湖人	idww
小薇	ihat
棉花糖	sraw
龙域	dxfa
对表	cfge
浦江	igia
安防	pvby
安陆	pvbg
绥中	xekh
泊美	irug
委以重任	tvny
紫菱	hxaf
紫萱	hxap
民院	nabp
黄狗	amqt
超链接	fhql
宝钗	pgqc
小蛋	ihnh
踢脚线	khef
山竹	mmth
便利店	wgtj
汇通	iace
测点	imhk
米高	oyyk
大盘鸡	ddte
结关	xfud
财院	mfbp
麻瓜	osrc
黄珍	amgw
龙威	dxdg
岩画	mdgl
精简版	ogtu
红塔	xafa
赛迪	pamp
技能书	rfce
毒龙	gxdx
定陶	pgbq
宜阳	pebj
血本无归	tlsg
小乌龟	ihqn
清宫	igpk
室长	pgta
海泰	itdw
小袋	ihwa
巴东	cnai
尼莫	nxaj
结单	xful
见者有份	mqft
跳级	khxb
海涛	itid
自寻烦恼	thvf
素衣	gxye
鸭血	lqtl
涤棉	itsr
精钢	ogqm
白眼狼	rrhv
精铁	ogqr
路考	khft
辅件	lgwt
湾仔	iywb
续写	xfpg
沙角	iiqe
泡脚	iqef
汽贸	irqy
江都	iaft
黄皮	amhc
巨兽	anul
纯奶	xgvb
川北	ktux
维克	xwdq
紫装	hxuf
黄家驹	ampg
鼎湖	hnid
车友	lgdc
绝味	xqkf
洞窟	impw
周杰伦	mfso
车台	lgck
巨剑	anwg
龙川	dxkt
作业区	wtog
工勤	aaak
转印	lfqg
女人心	vvww
巨力	anen
泡芙	iqaf
市侩	ymww
黑皮	lfhc
红山	xamm
陈小春	baih
清影	igjy
工单	aaul
绿光	xvig
小象	ihqk
宾阳	prbj
差动	ugfc
黄磊	amdd
马里奥	cgjf
富锦	pgqr
布偶	dmwj
左后	darg
小贝	ihmh
小老鼠	ihft
寒铁	paqr
轻卡	lchg
温岚	ijmw
考核表	ftsy
温岭	ijmw
山航	mmte
巴南	cnfm
赤铜	foqm
消火	iioo
轿厢	ltds
鼓点	fkhk
红底	xaoq
江铃	iaqw
江铜	iaqm
对酒	cfis
尿裤	nipu
液氮	iyrn
湖塘	idfo
罗湖区	lqid
线宽	xfpa
涟源	ilid
何仙姑	wswm
没趣	iwfh
涵江	ibia
辉县	igeg
巡场	vpfn
边个	epwh
韦小宝	fnih
咸鸭蛋	dglq
江阳	iabj
培训费	fuyk
龙手	dxrt
白白胖胖	rrrr
封釉	ffto
小情歌	ihng
富顺	pgkd
路虎	khha
编办	xyew
江雪	iafv
比武招亲	xxfh
足足	khkh
水鱼	iiqg
帅吧	jmkc
账龄	mthw
蹲着	khug
踢脚	khef
烦心事	odny
老妈子	ftvc
跨行	khtg
辰光	dfig
绿园	xvlf
工大	aadd
海皇	itrg
汉魅	icrq
君子好逑	vtbb
餐饮部	hqqn
织带	xkgk
绿坝	xvfm
油路	imkh
黄纸	amxq
黄线	amxf
浅紫	ifhx
演员表	ipkm
细度	xloa
嵊泗	mtil
巫女	awvv
巫妖	awvt
深棕	ipsp
黄网	ammr
由内而外	mhmw
校领导	sywy
尿路	nikh
还书	dhnn
纲手	xmrt
跟读	khyf
寿阳	dtbj
跑路	khkh
跑跑	khkh
达利	dptj
进仓	fjwb
泳裤	iypu
洛萨	itab
欧姆龙	arvx
老娘们	ftvy
麦蒂	gtay
富士康	pgfg
幅值	mhwf
巡山	vpmm
浮空	iepw
嫦娥奔月	vivt
辽化	bpwx
文化课	yywx
六里桥	ywjf
淘淘	iqiq
龙柏	dxsr
市外	ymqh
波谷	ihww
鸡飞狗跳	cqnu
六人行	ywww
维尼	xwnx
二话不说	fgyt
路试	khyg
迪亚	mpgo
满人	iaww
流脓	iyep
疯疯癫癫	uwuw
绵山	xrmm
绝影	xqjy
软工	lqaa
黑胶	lfey
校园卡	sylf
邋里邋遢	vljf
儿女私情	qtvv
迭代	rwwa
线损	xfrk
巴尔	cnqi
线控	xfrp
张震岳	xtfd
运功	fcae
文化路	yywx
泥质	inrf
跷课	khyj
紫钻	hxqh
泰诺	dwya
海飞丝	itnu
深泽	ipic
大费周章	ddxj
帐套	mhdd
纳斯	xmad
火龙果	oodx
索隆	fpbt
近卫	rpbg
跑酷	khsg
非洲人	hdiy
转性	lfnt
年中	rhkh
平乐	gutn
深港	ipia
巴州	cnyt
鼻癌	thuk
辣妹	udvf
胡彦斌	deut
杨浦区	snig
翟红新	nwxa
紫陌	hxbd
奋力拼搏	dlen
赤龙	fodx
迪克	mpdq
迪兰	mpud
躲着	tmug
山贼	mmma
黑莓	lfat
麟角	onqe
滑县	imeg
紫雪	hxfv
温格	ijst
紫霞	hxfn
恐惧症	awnh
清波	igih
素颜	gxut
业务费	ogte
跳车	khlg
追债	wnwg
纽曼	xnjl
躺着	tmug
迪加	mpek
退信	vewy
辣子	udbb
自由幻想	thmh
淬炼	iyoa
庆丰	oddh
清淤	igiy
线束	xfgk
泡酒	iqis
庆云	odfc
泰达	dwdp
工房	aayn
泰迪	dwmp
辽大	bpdd
泵车	dilg
专用章	fneh
滦南	iyfm
玛丽亚	gcgm
线框	xfsa
鸭脖子	lqef
万亩	gqyl
黑虎	lfha
龙湖	dxid
造业	tfog
辞工	tdaa
三份	dgww
龙溪	dxie
万佳	gqwf
小鱼	ihqg
辛庄	ufof
维拉	xwru
不仁	dhwf
工控	aarp
值班表	wfgy
下位	ghwu
缴存	xrdh
农家乐	pepg
情深义重	ngip
轮播	lwrt
清火	igoo
群主	vtyg
糊糊涂涂	odod
达子	dpbb
温江	ijia
绘本	xwsg
年卡	rhhg
龅牙	hwah
学生票	iptg
庆元	odfq
海航	itte
宅急送	ptqv
嚎啕大哭	kykq
法防	ifby
港汇	iaia
迁安	tfpv
绝杀	xqrs
法阵	ifbl
丢丑	tfnh
亡命徒	ynwg
海苔	itac
泗阳	ilbj
鸡鸡	cqcq
常宁	ipps
中括号	khrt
涂膜	iwea
滑头	imud
广医	oyat
断肠草	onen
广华	oywx
下册	ghmm
万利	gqtj
市场价	ymfn
踩踏	khkh
三刀	dgvn
踩踩	khkh
小公司	ihwc
造兵	tfrg
两份	gmww
转来	lfgo
车标	lgsf
大坏蛋	ddfd
七区	agar
续期	xfad
维普	xwuo
辽师	bpjg
答题卡	twjg
一名	ggqk
麦迪	gtmp
边度	epoa
丰乐	dhtn
艾弗森	arxj
红点	xahk
龙猫	dxqt
惜字如金	napb
东光	aiig
迪奥	mptm
广商	oyyu
三厢	dgds
梦幻诛仙	ssxn
平四	gulh
一品	ggkk
三双	dgcc
三友	dgdc
刚柔并济	mrcn
上口	hgkk
熠熠生辉	onon
罗定	lqpg
常平	ipgu
蜘蛛侠	jtjr
黑涩会	lfiv
罗宾	lqpr
泰阳	dwbj
雷克萨斯	fldq
下吧	ghkc
暮光之城	ajig
紫龙	hxdx
罗尼	lqnx
辩手	udrt
海虹	itja
世华	anwx
红牛	xatg
主从	ygww
注音	iyuj
美国派	uglg
流走	iyfh
连山	lpmm
辅机	lgsw
广园	oylf
辅材	lgsf
幻城	xnfd
东华	aiwx
群号	vtkg
路飞	khnu
追她	wnvb
洪都	iaft
美圆	uglk
转款	lfff
东口	aikk
建设厅	vgyw
为人处世	ytww
帮战	dthk
第二季度	txfg
网建	mrvg
连州	lpyt
逆天	ubgd
三回	dglk
布林	dmss
罗庄	lqof
乐乐	tntn
漫友	ijdc
两双	gmcc
乐亭	tnyk
下图	ghlt
布标	dmsf
上地	hgfb
幺妹	xxvf
洁面	ifdm
黑车	lflg
白雪皑皑	rrfv
纯玩	xggf
达拉	dpru
通城	cefd
丰华	dhwx
黑边	lfep
蹭课	khyj
专四	fnlh
巨汗	anif
促销员	wkqi
淡紫	iohx
远志	fqfn
一姐	ggve
美妞	ugvn
川渝	ktiw
风火轮	wroo
东四	ailh
测速	imgk
注意事项	iyuj
红皮	xahc
安全员	pvwg
左海	dait
轴流	lmiy
纯生	xgtg
红盾	xarf
李俊基	sbwc
数码管	ovdc
流金	iyqq
伪政府	wygh
广安	oypv
绩溪	xgie
次级债	uqxb
潮人	ifww
清穿	igpw
主叫	ygkn
逍客	iept
通威	cedg
淋膜	isea
麦霸	gtfa
蔡依林	awwy
属鸡	ntcq
红石	xadg
达斯	dpad
东塔	aifa
一宿	ggpw
翻书	tonn
庆安	odpv
绿泥	xvin
一寸	ggfg
七宝	agpg
翔升	ugta
巫溪	awie
并州	uayt
黄钻	amqh
建业	vgog
红磡	xada
属鼠	nten
海贝	itmh
滥情	ijng
连招	lprv
连拍	lprr
三家	dgpg
俞灏明	wgij
他们俩	wbwu
平开	guga
纸皮	xqhc
下家	ghpg
三层	dgnf
三居	dgnd
两处	gmth
三山	dgmm
巨灵	anvo
店子	ohbb
麦香	gttj
淘宝店	iqpg
黄陂	ambh
湿湿	ijij
康城	ovfd
品质部	kkrf
黑钻	lfqh
黄陵	ambf
迪拜	mprd
两委	gmtv
海盗船	ituq
网文	mryy
一平	gggu
洗髓	itme
乘号	tukg
工程量	aatk
主城	ygfd
二七	fgag
女人缘	vvww
广德	oytf
济钢	iyqm
大好人	ddvb
二中	fgkh
上师	hgjg
九台	vtck
床底	osoq
遵化	uswx
下市	ghym
康夫	ovfw
于丹	gfmy
预算员	cnth
绿点	xvhk
二人	fgww
建兴	vgig
避而远之	nkdm
小户型	ihyn
上庸	hgov
井上	fjhg
专工	fnaa
网板	mrsr
龙纹	dxxy
深航	ipte
三强	dgxk
那事	nggk
黑雾	lfft
溧水	isii
漫展	ijna
呼啦圈	ktkr
两居	gmnd
店庆	ohod
罗村	lqsf
干挂	fgrf
罗杰	lqso
淡蓝	ioaj
大福源	ddpy
道奇	utds
纹章	xyuj
乜嘢	nnkj
混色	ijqc
潼南	iufm
东市	aiym
线稿	xfty
建卡	vghg
临客	jtpt
东北话	aiux
五倍	ggwu
邵东	vkai
郎情妾意	yvng
黄骅	amcg
红纸	xaxq
龙脊	dxiw
红绳	xaxk
张俊	xtwc
布片	dmth
一抹	ggrg
开县	gaeg
开叉	gacy
灯火通明	osoo
床戏	osca
麦麦	gtgt
两床	gmos
偏执狂	wyrv
差生	ugtg
买啥	nukw
轻甲	lclh
开吃	gakt
专情	fnng
花姑娘	awvd
羊排	ugrh
张健	xtwv
一捆	ggrl
上房	hgyn
漳平	iugu
龙舞	dxrl
海鑫	itqq
辉瑞	iggm
亚光	goig
转矩	lftd
航天桥	tegd
亚克	godq
返款	rcff
合家团圆	wgpg
潘婷	itvy
采集器	eswy
遂平	uegu
张军	xtpl
过海	fpit
专户	fnyn
奥特曼	tmtf
三文鱼	dgyy
临平	jtgu
快递员	nnux
店招	ohrv
井区	fjar
巴盟	cnje
海阔	itui
年来	rhgo
孙国政	bilg
美文	ugyy
绿盟	xvje
黑鱼	lfqg
帅男	jmle
罗江	lqia
翻墙	toff
张华	xtwx
无法自拔	fqif
浴霸	iwfa
岳麓	rgss
练级	xaxb
连江	lpia
平桥	gust
朝阳门	fjbj
睫毛膏	hgtf
红英	xaam
广本	oysg
红双喜	xacc
潜山	ifmm
蹭饭	khqn
五哥	ggsk
丽影	gmjy
速攻	gkat
人偶	wwwj
乔峰	tdmt
百转千回	djlf
淘课	iqyj
交单	ywul
曹妃甸	gmvn
邀请码	ryyg
黄龙	amdx
建外	vgqh
交卷	ywud
亮剑	ykwg
老套	ftdd
黑鸟	lfqy
九尾	vtnt
九层	vtnf
混装	ijuf
黑鹰	lfow
底料	oqou
交口	ywkk
老妖	ftvt
美林	ugss
扫描件	rvra
港航	iate
纸膜	xqea
老姑	ftvd
人兽	wwul
养虎为患	ufha
乐平	tngu
龙蛋	dxnh
小猫咪	ihqt
滤波	ihih
通杀	cers
绵竹	xrth
潢川	iakt
万柳	gqsq
三枪	dgsw
丙方	gmyy
郭丽	ykgm
中控	khrp
上柜	hgsa
仙仙	wmwm
三档	dgsi
返点	rchk
疏忽大意	nhqr
幡然醒悟	mhqd
近照	rpjv
练舞	xarl
建宁	vgps
仙侠	wmwg
帝皇	yurg
涨钱	ixqf
远程协助	fqtk
二天	fggd
两方	gmyy
归元	jvfq
师祖	jgpy
强吻	xkkq
店标	ohsf
彩京	esyk
郑全战	udwg
绿箭	xvtu
迟点	nyhk
保健品	wkwv
东村	aisf
平泉	guri
涡阳	ikbj
郏县	gueg
主控	ygrp
聊友	bqdc
二姨	fgvg
赵本山	fhsg
奸夫淫妇	vffw
网版	mrth
中新	khus
那好	ngvb
中旅	khyt
废柴	onhx
美欧	ugar
二婶	fgvp
网络部	mrxt
两本	gmsg
迈瑞	gqgm
仙儿	wmqt
虎虎生威	haha
翘首以盼	atut
主播	ygrt
羊汤	ugin
老帖	ftmh
情比金坚	ngxx
红袖	xapu
该当何罪	yyiv
巡考	vpft
返现	rcgm
软考	lqft
小护士	ihry
归原	jvdr
仙剑	wmwg
老干	ftfg
云子	fcbb
平平凡凡	gugu
推广员	rwoy
东楼	aiso
万水	gqii
肆仟	dcwt
二居	fgnd
镇江市	qfia
手机报	rtsw
平潭	guis
广深	oyip
通江	ceia
老徐	fttw
中核	khsy
肆佰	dcwd
绿线	xvxf
上汽	hgir
通河	ceis
七海	agit
待人	tfww
港行	iatg
碧桂园	grsf
清者自清	igft
网申	mrjh
左脸	daew
五层	ggnf
五岁	ggmq
张宁	xtps
张宇	xtpg
缆线	xjxf
通海	ceit
干点	fghk
漏液	iniy
进度条	fjoa
五峰	ggmt
弦子	xybb
网瘾	mrub
红警	xaaq
游街	iytf
俯首称臣	wout
危险源	qdbw
幻灵	xnvo
平煤	guoa
安全期	pvwg
上港	hgia
漠河	iais
网监	mrjt
男人味	leww
都匀	ftqu
乐昌	tnjj
东江	aiia
份儿	wwqt
占有欲	hkde
伍佰	wgwd
轻舞	lcrl
肥东	ecai
东泉	airi
五常	ggip
潍柴	ixhx
老房	ftyn
郑大	uddd
五庄	ggof
仙器	wmkk
歪歪斜斜	dhdh
亏心	fnny
考拉	ftru
那得	ngtj
万灵	gqvo
京山	ykmm
外焦里嫩	qhwy
缓考	xeft
肥佬	ecwf
张庄	xtof
张庭	xtot
交州	ywyt
期中考试	adkh
气势恢宏	rnrv
维萨	xwab
引怪	xhnc
任县	wteg
宣传册	pgwf
耐打	dmrs
缘聚	xxbc
滚石	iydg
伊利	wvtj
征友	tgdc
龟速	qjgk
临水	jtii
亦庄	yoof
漳浦	iuig
羽泉	nnri
巴萨	cnab
丰泽	dhic
临泉	jtri
近端	rpum
徐勇	twce
仁寿	wfdt
大姐头	ddve
一环	gggd
仿品	wykk
布草	dmaj
淤青	iyge
大姐大	ddve
美玲	uggw
微信	tmwy
淮阳	iwbj
彭城	fkfd
弱弱	xuxu
工资卡	aauq
七班	aggy
工资单	aauq
临清	jtig
转行	lftg
宣传单	pgwf
底物	oqtq
人帅	wwjm
聚宝	bcpg
专版	fnth
彩壳	esfp
背上	uxhg
陈一丹	bagg
巨蟒	anja
上环	hggd
一瓶	ggua
估值	wdwf
酒业	isog
股友	ewdc
美甲	uglh
乐毅	tnue
结课	xfyj
伤到	wtgc
巴蜀	cnlq
部室	ukpg
老枪	ftsw
过级	fpxb
潇湘	iais
三瓶	dgua
开服	gaeb
缺考	rmft
交房	ywyn
老柴	fthx
微创	tmwb
软解	lqqe
羽灵	nnvo
范德萨	aitf
游过	iyfp
德兴	tfig
美白	ugrr
两片	gmth
铝塑板	qkub
估分	wdwv
达能	dpce
当差	ivug
透着	tbug
练车	xalg
运维	fcxw
丑男	nhle
大姨妈	ddvg
微博	tmfg
联强	buxk
清零	igfw
低位	wqwu
乐清	tnig
网维	mrxw
转诊	lfyw
搅拌站	riru
逃票	qisf
美瞳	ughu
消音器	iiuj
冰封王座	uiff
三相	dgsh
德勤	tfak
四季如春	lhtb
两限房	gmbv
张敏	xttx
高新区	ykus
网罩	mrlh
两班	gmgy
混饭	ijqn
心凌	nyuf
张斌	xtyf
张文	xtyy
读卡器	yfhg
翠湖	nyid
车贷	lgwa
渔阳	iqbj
迈腾	gqeu
低值	wqwf
彭山	fkmm
选秀	tftb
一磅	ggdy
胡侃	dewk
张明	xtje
张韶涵	xtuj
完完整整	pfpf
网聊	mrbq
进群	fjvt
肃宁	vips
两瓶	gmua
干管	fgtp
中班	khgy
代币	watm
火云	oofc
差评	ugyg
火人	ooww
三碗	dgdp
酒劲	isca
康王	ovgg
皮卡丘	hchg
肥城	ecfd
举牌	igth
待嫁	tfvp
满级	iaxb
小王子	ihgg
悲喜交加	hdfk
伊娃	wvvf
张杰	xtso
胎压	ecdf
濑户	igyn
美空	ugpw
仙剑奇侠传	wmwg
胡军	depl
邓欣	cbrq
三科	dgtu
翠烟	nyol
交期	ywad
遁甲	rflh
徽商	tmyu
雇佣兵	ynwe
丽珠	gmgr
佐助	wdeg
五楼	ggso
纯阳	xgbj
通稿	cety
一签	ggtw
彬彬	ssss
肥妞	ecvn
白头发	rrud
肘子	efbb
肥妹	ecvf
酒品	iskk
同花顺	mgaw
遛狗	qyqt
仪征	wytg
红领	xawy
张楚	xtss
御姐	trve
两码	gmdc
纯露	xgfk
乳源	ebid
纳雍	xmyx
澄海	iwit
淘宝网	iqpg
建湖	vgid
平纹	guxy
龙魂	dxfc
和睦相处	tkhf
九型人格	vtga
师说	jgyu
设备部	ywtl
一系	ggtx
罗莎	lqai
翘班	atgy
股室	ewpg
维达	xwdp
库管	oltp
神经兮兮	pyxc
灵兽	voul
弘毅	xcue
二泉	fgri
退群	vevt
仲恺	wknm
云水	fcii
五毛	ggtf
三精	dgog
御宅	trpt
三系	dgtx
滤芯	ihan
溶血	iptl
今早	wyjf
绿软	xvlq
买烟	nuol
龙鳞	dxqg
老火	ftoo
线面	xfdm
灵力	voen
巨野	anjf
平胸	gueq
红魔	xaos
聚星	bcjt
团结湖	lfxf
七组	agxe
胶南	eyfm
九班	vtgy
两站	gmuh
心墙	nyff
帮规	dtfw
连连看	lplp
一文不值	ggyy
经院	xcbp
安全码	pvwg
亚泰	godw
遮瑕	oagn
龙鸣	dxkq
帝豪	yuyk
神雕侠侣	pymf
万网	gqmr
佳华	wfwx
合同号	wgmg
综采	xpes
张海	xtit
老版	ftth
老片	ftth
亨氏	ykqa
张涛	xtid
新手区	usrt
肩带	yngk
一胎	ggec
邻水	wyii
美股	ugew
炫丽	oygm
佳吉	wffk
郭晓	ykja
龙龟	dxqj
很懒	tvng
耳洞	bgim
湘雅	isah
软银	lqqv
仙术	wmsy
滇西	ifsg
格斗家	stuf
胖妹	euvf
钟点房	qkhk
平菇	guav
仙林	wmss
魔兽争霸	osul
火圈	oolu
进补	fjpu
老班	ftgy
游魂	iyfc
结项	xfad
乔石	tddg
律所	tvrn
结题	xfjg
一艘	ggte
五灵	ggvo
周大侠	mfdd
配属	sgnt
不见不散	dhmq
胶圈	eylu
女大当嫁	vvdd
软陶	lqbq
邪灵	ahvo
两组	gmxe
群聊	vtbq
速腾	gkeu
红龙	xadx
兔斯基	qkad
连襟	lppu
伤怀	wtnd
满血	iatl
远观	fqcm
万花	gqaw
绿钻	xvqh
思创	lnwb
耐玩	dmgf
不舍	dhwf
胚子	edbb
胸垫	eqrv
三花	dgaw
心手相连	nyrt
生不如死	tgdh
回龙观	lkdx
美女们	ugvv
美菱	ugaf
翻盘	tote
烂人	ouww
东胜	aiet
轻院	lcbp
帕里	mhjf
买盘	nute
火女	oovv
纸鸢	xqay
异界	nalw
酸辣粉	sgud
三药	dgax
任宇昕	wtpg
录歌	visk
滴蜡	iyja
张燕	xtak
老皮	fthc
快女	nnvv
聚气	bcrn
巴陵	cnbf
亚特	gotf
胶套	eydd
德性	tfnt
自然醒	thqd
五环	gggd
帅锅	jmqk
边道	eput
俊丽	wcgm
缩量	xpjg
中联	khbu
郑源	udid
便便	wgwg
门头沟	uyud
巫颂	awwc
恒丰	ngdh
重做	tgwd
烟台万华	olck
仙气	wmrn
张玉	xtgy
好乐迪	vbtn
供品	wakk
点券	hkud
考砸	ftda
网路	mrkh
股改	ewnt
胎心	ecny
主群	ygvt
近身	rptm
节能灯	abce
亚瑟	gogg
快客	nnpt
库藏	olad
点单	hkul
金典	qqma
重出	tgbm
耗着	diug
便函	wgbi
工资条	aauq
素未谋面	gxfi
点号	hkkg
巨魔	anos
仙游	wmiy
一袋	ggwa
仙湖	wmid
辛集	ufwy
世界和平	anlw
老窝	ftpw
老窖	ftpw
京珠	ykgr
铿锵有力	qjqu
执子之手	rvbb
巴马	cncg
异种	natk
乐美	tnug
带钱	gkqf
忘性	ynnt
促动	wkfc
思域	lnfa
怀宁	ndps
信佛	wywx
开窗	gapw
郑爽	uddr
下行	ghtg
灰常	doip
张相	xtsh
德政	tfgh
腻了	edbn
火影	oojy
缺钙	rmqg
西三旗	sgdg
仙灵	wmvo
缺钱	rmqf
底裤	oqpu
翘臀	atna
钱三强	qfdg
选词	tfyn
丽莎	gmai
强生	xktg
配电室	sgjn
精诚所至	ogyd
边间	epuj
宫崎骏	pkmd
劳斯莱斯	apad
完成率	pfdn
快快	nnnn
巨鹿	anon
人界	wwlw
二章	fguj
邪神	ahpy
保利	wktj
侍寝	wfpu
乌苏	qnae
习近平	nurp
总在	ukdh
毁尸灭迹	eann
武器店	fhkk
烟厂	oldg
弯矩	yotd
两行	gmtg
念念	wywy
名侦探柯南	qkwh
五章	gguj
热刺	rvgm
烧包	oaqn
万豪	gqyk
金地	qqfb
老罗	ftlq
烟味	olkf
美资	uguq
运镖	fcqs
张立	xtuu
金坛	qqff
退运	vefc
令牌	wyth
腾冲	euuk
